RANK,MOVEMENT,PLAYER_ID,PLAYER,TOTAL,DISTANCE RANK,ACCURACY RANK
1,0,52955,Ludvig Åberg,33,6,27
2,0,39546,Keith Mitchell,62,14,48
3,0,35450,Patrick Cantlay,63,37,26
4,0,51414,Brent Grant,68,25,43
5,0,46717,Viktor Hovland,84,44,40
5,0,58696,Peter Kuest,84,2,82
7,0,56762,Will Gordon,91,21,70
8,0,55708,Hayden Buckley,94,65,29
9,0,46046,Scottie Scheffler,95,31,64
10,0,45242,Kevin Yu,96,23,73
11,0,56630,Akshay Bhatia,97,59,38
12,0,52372,Cameron Champ,99,4,95
13,0,48867,Matti Schmid,105,10,95
14,0,33204,Shane Lowry,108,71,37
15,0,57366,Cameron Young,113,7,106
16,0,58168,Davis Thompson,121,31,90
17,0,57362,Austin Eckroat,123,88,35
17,0,35310,Lanto Griffin,123,81,42
19,0,45609,Tyler Duncan,128,115,13
20,0,52375,Doug Ghim,129,119,10
21,0,55182,Tom Kim,133,121,12
22,0,28089,Jason Day,134,66,68
22,0,31323,Gary Woodland,134,13,121
24,0,51070,Vincent Norrman,136,9,127
25,0,49960,Sepp Straka,138,105,33
26,0,46970,Jon Rahm,140,11,129
27,0,37455,Si Woo Kim,141,130,11
28,0,50525,Collin Morikawa,142,134,8
29,0,39067,MJ Daffue,145,29,116
29,0,32448,James Hahn,145,114,31
31,0,30911,Tommy Fleetwood,148,81,67
31,0,31577,Tano Goya,148,77,71
33,0,34363,Tyrrell Hatton,149,48,101
34,0,50095,Austin Smotherman,150,94,56
35,0,25900,Lucas Glover,151,146,5
36,0,29725,Tony Finau,152,66,86
36,0,32102,Rickie Fowler,152,39,113
38,0,23320,Ryan Palmer,153,87,66
39,0,39977,Max Homa,155,62,93
39,0,50493,Justin Suh,155,108,47
41,0,39324,J.J. Spaun,156,115,41
42,0,46414,Aaron Rai,157,151,6
43,0,47504,Sam Burns,159,21,138
44,0,54421,Garrick Higgo,160,27,133
44,0,47995,Davis Riley,160,52,108
46,0,39971,Sungjae Im,162,110,52
47,0,31646,Emiliano Grillo,165,86,79
47,0,29221,Webb Simpson,165,103,62
49,0,47988,Nick Hardy,166,34,132
50,0,52513,Carson Young,167,142,25
51,0,33141,Keegan Bradley,168,54,114
52,0,34098,Russell Henley,169,168,1
53,0,39997,Corey Conners,170,92,78
53,0,39975,Michael Kim,170,58,112
55,0,51766,Wyndham Clark,171,15,156
55,0,33653,Thomas Detry,171,43,128
57,0,27644,Brian Harman,172,156,16
57,0,29420,Billy Horschel,172,117,55
57,0,28237,Rory McIlroy,172,1,171
60,0,40115,Adam Svensson,173,134,39
61,0,36724,Augusto Núñez,175,33,142
61,0,55893,Sam Stevens,175,28,147
63,0,49298,Kramer Hickok,176,131,45
63,0,36799,Stephan Jaeger,176,50,126
63,0,50188,S.H. Kim,176,36,140
66,0,45157,Cam Davis,177,26,151
67,0,32640,Troy Merritt,178,158,20
68,0,49453,Trevor Cone,179,11,168
68,0,40250,Taylor Pendrith,179,30,149
70,0,40006,Erik van Rooyen,181,59,122
71,0,35449,Adam Long,182,168,14
72,0,27129,Luke List,183,23,160
73,0,32816,Satoshi Kodaira,184,181,3
74,0,39954,Cody Gribble,186,99,87
74,0,33399,Adam Hadwin,186,140,46
74,0,27936,Martin Laird,186,164,22
74,0,26596,Ryan Moore,186,182,4
78,0,33948,Byeong Hun An,187,8,179
78,0,34076,Joel Dahmen,187,136,51
78,0,35461,Beau Hossler,187,57,130
78,0,24502,Adam Scott,187,17,170
78,0,46340,Alex Smalley,187,78,109
83,0,36871,Matt NeSmith,188,128,60
84,0,19803,Ryan Armour,189,187,2
84,0,54628,Lee Hodges,189,95,94
86,0,34099,Harris English,190,125,65
86,0,31557,Jim Herman,190,172,18
86,0,24024,Zach Johnson,190,171,19
86,0,32791,K.H. Lee,190,91,99
90,0,49947,Taylor Moore,191,46,145
91,0,52453,Nicolai Hojgaard,192,5,187
91,0,33448,Justin Thomas,192,38,154
93,0,39335,Kevin Roy,194,75,119
94,0,51491,Brandon Matthews,195,3,192
95,0,23108,Matt Kuchar,196,147,49
96,0,40058,Zac Blair,197,190,7
96,0,35879,Kelly Kraft,197,180,17
98,0,12716,Charley Hoffman,198,50,148
98,0,22405,Justin Rose,198,144,54
98,0,30927,Brendon Todd,198,189,9
101,0,34255,Joseph Bramlett,199,18,181
101,0,26476,Chez Reavie,199,178,21
101,0,36699,Patrick Rodgers,199,35,164
101,0,48081,Xander Schauffele,199,68,131
105,0,48699,Callum Tarren,204,19,185
106,0,51349,Nico Echavarria,206,108,98
106,0,40098,Matt Fitzpatrick,206,68,138
106,0,52411,Kyle Westmoreland,206,15,191
109,0,34409,David Lingmerth,207,192,15
109,0,29908,C.T. Pan,207,132,75
109,0,47347,Adam Schenk,207,54,153
109,0,54783,Dylan Wu,207,118,89
113,0,28252,Seamus Power,208,98,110
114,0,29535,Brice Garnett,209,177,32
114,0,35901,Paul Haley II,209,186,23
114,0,28775,Nate Lashley,209,124,85
114,0,46601,Trey Mullinax,209,20,189
114,0,52374,Brandon Wu,209,140,69
114,0,55454,Carl Yuan,209,47,162
120,0,39058,Lucas Herbert,210,64,146
121,0,33413,Ben Martin,211,154,57
121,0,34046,Jordan Spieth,211,74,137
121,0,47128,Richy Werenski,211,93,118
124,0,27554,Scott Harrington,212,39,173
124,0,30926,Chris Kirk,212,133,79
124,0,36326,David Lipsky,212,162,50
127,0,33410,Andrew Landry,214,178,36
128,0,32757,Patton Kizzire,215,90,125
128,0,31202,William McGirt,215,191,24
128,0,51890,Greyson Sigg,215,138,77
128,0,32333,Kevin Tway,215,39,176
132,0,46435,Austin Cook,216,188,28
132,0,47993,Denny McCarthy,216,143,73
134,0,24140,Sean O'Hair,217,159,58
134,0,22056,Cameron Percy,217,173,44
134,0,49771,J.T. Poston,217,129,88
137,0,34256,Andrew Putnam,218,184,34
137,0,53165,Doc Redman,218,157,61
139,0,51997,Andrew Novak,219,102,117
140,0,47079,Harrison Endycott,220,161,59
141,0,27214,Kevin Streelman,222,125,97
142,0,31560,Brian Stuard,223,193,30
142,0,25632,Jimmy Walker,223,45,178
144,0,35617,Martin Trainer,224,83,141
145,0,34610,Matthias Schwab,225,153,72
146,0,59018,Ryan Gerard,226,119,107
147,0,28420,Ryan Brehm,227,39,188
147,0,32839,Hideki Matsuyama,227,127,100
149,0,30163,Henrik Norlander,228,165,63
150,0,20229,Stewart Cink,230,56,174
150,0,34563,Chesson Hadley,230,110,120
152,0,30692,Scott Stallings,231,88,143
152,0,51634,Sahith Theegala,231,59,172
154,0,48117,Kurt Kitayama,232,49,183
154,0,49766,Hank Lebioda,232,121,111
154,0,55789,Taylor Montgomery,232,71,161
154,0,47983,Chad Ramey,232,148,84
158,0,32366,Kevin Chappell,234,84,150
159,0,25686,Jason Dufner,236,112,124
159,0,33122,Russell Knox,236,183,53
159,0,48887,Matt Wallace,236,79,157
162,0,58967,Trevor Werbylo,237,53,184
163,0,32662,Michael Gligic,238,63,175
164,0,37338,Zecheng Dou,239,80,159
165,0,35532,Tom Hoge,240,137,103
166,0,54591,Ben Griffin,241,97,144
167,0,45522,Christiaan Bezuidenhout,242,167,75
168,0,36801,Mark Hubbard,246,163,83
169,0,29289,S.Y. Noh,249,73,176
170,0,25818,Scott Piercy,250,159,91
171,0,27349,Alex Noren,251,96,155
172,0,33597,Harry Higgs,252,85,167
172,0,40162,Justin Lower,252,150,102
174,0,24925,Jonathan Byrd,254,173,81
174,0,48119,Ben Taylor,254,68,186
176,0,46441,Robby Shelton,256,151,105
177,0,35506,Mackenzie Hughes,257,105,152
177,0,46442,Maverick McNealy,257,99,158
177,0,34431,Robert Streb,257,121,136
180,0,57975,Harry Hall,266,101,165
181,0,27963,Chris Stroud,267,175,92
182,0,48084,Wesley Bryan,269,103,166
182,0,29970,Dylan Frittelli,269,76,193
182,0,25493,Nick Taylor,269,155,114
185,0,51950,Max McGreevy,273,170,103
186,0,33408,Tyson Alexander,274,105,169
187,0,47591,Eric Cole,276,113,163
188,0,37275,Sam Ryder,283,148,135
189,0,32139,Danny Willett,289,166,123
190,0,22371,Aaron Baddeley,319,185,134
191,0,34466,Peter Malnati,326,144,182
192,0,27095,Nick Watney,328,138,190
193,0,27974,Sung Kang,356,176,180