RANK,MOVEMENT,PLAYER_ID,PLAYER,VALUE,TOTAL DRV RANK,GIR RANK
1,0,25364,Paul Casey,7,3,4
2,0,30946,Alex Prugh,8,5,3
3,0,39997,Corey Conners,11,10,1
3,0,29518,Brendan Steele,11,1,10
5,0,36689,Brooks Koepka,23,12,11
6,0,21961,Charles Howell III,24,17,7
7,0,49960,Sepp Straka,30,4,26
7,0,31323,Gary Woodland,30,2,28
9,0,25818,Scott Piercy,35,26,9
10,0,27936,Martin Laird,40,26,14
11,0,30944,Jason Kokrak,41,9,32
12,0,46970,Jon Rahm,44,15,29
12,0,27214,Kevin Streelman,44,29,15
14,0,31646,Emiliano Grillo,46,12,34
15,0,28237,Rory McIlroy,47,8,39
16,0,28089,Jason Day,48,32,16
17,0,33141,Keegan Bradley,51,11,40
18,0,32839,Hideki Matsuyama,53,33,20
19,0,25686,Jason Dufner,56,51,5
20,0,49964,Aaron Wise,62,24,38
21,0,49766,Hank Lebioda,65,40,25
22,0,25900,Lucas Glover,70,20,50
22,0,33448,Justin Thomas,70,64,6
22,0,27064,Jhonattan Vegas,70,47,23
25,0,29535,Brice Garnett,71,53,18
25,0,32640,Troy Merritt,71,40,31
27,0,29268,Bronson Burgoon,72,18,54
28,0,24781,Hunter Mahan,77,31,46
29,0,48081,Xander Schauffele,81,38,43
30,0,33667,Carlos Ortiz,87,29,58
31,0,28679,Fabián Gómez,88,37,51
31,0,45486,Joaquin Niemann,88,35,53
33,0,45157,Cam Davis,89,56,33
33,0,23108,Matt Kuchar,89,69,20
35,0,47347,Adam Schenk,91,55,36
35,0,37340,Chase Wright,91,35,56
37,0,39971,Sungjae Im,93,26,67
38,0,52372,Cameron Champ,94,72,22
39,0,33418,Shawn Stefani,95,83,12
40,0,45609,Tyler Duncan,97,56,41
41,0,32102,Rickie Fowler,99,40,59
41,0,35732,Wes Roach,99,34,65
43,0,29970,Dylan Frittelli,104,56,48
44,0,49298,Kramer Hickok,105,23,82
45,0,26476,Chez Reavie,106,49,57
46,0,33399,Adam Hadwin,107,38,69
47,0,27330,Josh Teater,108,100,8
48,0,30911,Tommy Fleetwood,109,22,87
48,0,26329,Louis Oosthuizen,109,16,93
50,0,45526,Abraham Ancer,110,14,96
51,0,34098,Russell Henley,113,62,51
52,0,39546,Keith Mitchell,118,43,75
53,0,47959,Bryson DeChambeau,119,6,113
53,0,27095,Nick Watney,119,83,36
55,0,10809,Jim Furyk,120,96,24
55,0,37275,Sam Ryder,120,66,54
57,0,34076,Joel Dahmen,121,20,101
58,0,33948,Byeong Hun An,124,64,60
58,0,23320,Ryan Palmer,124,79,45
58,0,30110,Kyle Stanley,124,51,73
61,0,40115,Adam Svensson,125,106,19
62,0,24502,Adam Scott,126,96,30
63,0,26596,Ryan Moore,127,78,49
63,0,33419,Cameron Tringale,127,110,17
65,0,34099,Harris English,135,44,91
66,0,33122,Russell Knox,136,110,26
67,0,33410,Andrew Landry,140,59,81
68,0,26951,Johnson Wagner,143,141,2
69,0,37189,Harold Varner III,144,67,77
70,0,40026,Daniel Berger,145,7,138
71,0,29725,Tony Finau,146,72,74
71,0,25804,Bubba Watson,146,49,97
73,0,46435,Austin Cook,149,19,130
73,0,29420,Billy Horschel,149,83,66
75,0,46402,Talor Gooch,154,142,12
76,0,34363,Tyrrell Hatton,155,45,110
76,0,29478,Kevin Kisner,155,70,85
78,0,48822,Sebastián Muñoz,157,110,47
79,0,35450,Patrick Cantlay,158,81,77
79,0,34306,John Chin,158,123,35
79,0,27349,Alex Noren,158,24,134
79,0,47856,Seth Reeves,158,63,95
83,0,35421,Brandon Harkins,159,96,63
84,0,34021,Bud Cauley,160,83,77
84,0,30925,Dustin Johnson,160,74,86
86,0,19803,Ryan Armour,163,95,68
86,0,23621,Rory Sabbatini,163,74,89
86,0,39324,J.J. Spaun,163,119,44
89,0,31557,Jim Herman,166,53,113
90,0,46601,Trey Mullinax,173,103,70
91,0,32200,Roberto Castro,174,132,42
92,0,27974,Sung Kang,177,61,116
93,0,26758,David Hearn,181,110,71
93,0,35449,Adam Long,181,47,134
93,0,49771,J.T. Poston,181,88,93
96,0,28775,Nate Lashley,187,115,72
97,0,32150,Michael Thompson,188,59,129
98,0,35376,Roberto Díaz,191,87,104
99,0,22405,Justin Rose,193,45,148
100,0,51766,Wyndham Clark,194,70,124
101,0,39327,Ben Silverman,195,88,107
102,0,47993,Denny McCarthy,196,74,122
102,0,24138,Ian Poulter,196,106,90
104,0,21528,Henrik Stenson,197,79,118
105,0,35461,Beau Hossler,200,116,84
106,0,23325,Vaughn Taylor,201,110,91
107,0,32333,Kevin Tway,204,121,83
108,0,26300,Matt Jones,206,103,103
109,0,46523,Joey Garber,208,100,108
110,0,32791,K.H. Lee,209,145,64
111,0,40009,Dominic Bozzelli,214,126,88
112,0,27141,J.B. Holmes,219,88,131
113,0,49303,Anders Albertson,220,159,61
113,0,27129,Luke List,220,88,132
115,0,47504,Sam Burns,223,74,149
115,0,29221,Webb Simpson,223,96,127
117,0,26851,Marc Leishman,224,147,77
118,0,25493,Nick Taylor,225,149,76
119,0,27644,Brian Harman,227,67,160
119,0,47990,Kyle Jones,227,106,121
121,0,36852,Jim Knous,229,168,61
122,0,29926,Danny Lee,231,132,99
123,0,23353,J.J. Henry,234,132,102
123,0,33486,Roger Sloan,234,93,141
125,0,29479,Scott Brown,235,130,105
125,0,34360,Patrick Reed,235,123,112
127,0,28259,Sangmoon Bae,238,88,150
128,0,30692,Scott Stallings,243,144,99
129,0,37455,Si Woo Kim,247,103,144
130,0,31560,Brian Stuard,251,106,145
131,0,21209,Sergio Garcia,254,81,173
132,0,34264,Hudson Swafford,262,165,97
133,0,12716,Charley Hoffman,268,162,106
134,0,27895,Jonas Blixt,270,130,140
135,0,25198,Francesco Molinari,271,102,169
136,0,47128,Richy Werenski,272,146,126
136,0,32139,Danny Willett,272,161,111
138,0,34563,Chesson Hadley,273,119,154
139,0,39977,Max Homa,274,135,139
140,0,19846,Brian Gay,275,117,158
141,0,30978,Kiradech Aphibarnrat,279,94,185
142,0,35532,Tom Hoge,281,153,128
143,0,25396,Kevin Na,282,126,156
144,0,35506,Mackenzie Hughes,284,150,134
145,0,24361,Pat Perez,285,152,133
145,0,27556,Ted Potter Jr.,285,176,109
147,0,01810,Phil Mickelson,286,126,160
148,0,36799,Stephan Jaeger,287,164,123
149,0,29484,Peter Uihlein,289,169,120
150,0,29974,Branden Grace,290,171,119
151,0,40098,Matt Fitzpatrick,291,125,166
152,0,37454,Whee Kim,292,177,115
152,0,36699,Patrick Rodgers,292,142,150
152,0,30786,Brady Schnell,292,137,155
152,0,34431,Robert Streb,292,175,117
156,0,29223,Sam Saunders,294,148,146
157,0,26499,Rafa Cabrera Bello,296,121,175
158,0,24024,Zach Johnson,297,117,180
159,0,27958,Ryan Blaum,299,157,142
160,0,32757,Patton Kizzire,302,137,165
161,0,25632,Jimmy Walker,303,153,150
162,0,27649,Brandt Snedeker,305,162,143
163,0,20472,Alex Cejka,306,150,156
164,0,32816,Satoshi Kodaira,307,137,170
164,0,46501,Ollie Schniederjans,307,129,178
166,0,24924,Bill Haas,308,155,153
166,0,34256,Andrew Putnam,308,183,125
168,0,25572,Graeme McDowell,319,173,146
168,0,29908,C.T. Pan,319,157,162
170,0,34261,Scott Langley,320,136,184
171,0,24925,Jonathan Byrd,324,187,137
171,0,35891,Cameron Smith,324,156,168
173,0,35617,Martin Trainer,327,140,187
174,0,32058,José de Jesús Rodríguez,328,169,159
175,0,20572,Rod Pampling,330,167,163
176,0,35879,Kelly Kraft,341,159,182
177,0,34466,Peter Malnati,345,181,164
178,0,31420,Anirban Lahiri,350,173,177
179,0,06522,Ernie Els,352,185,167
179,0,39954,Cody Gribble,352,166,186
181,0,30191,Julián Etulain,353,182,171
182,0,21731,Freddie Jacobson,354,180,174
182,0,28252,Seamus Power,354,171,183
182,0,27963,Chris Stroud,354,179,175
185,0,34046,Jordan Spieth,356,177,179
186,0,22371,Aaron Baddeley,358,186,172
187,0,37380,Curtis Luck,365,184,181
188,0,39975,Michael Kim,376,188,188