RANK,MOVEMENT,PLAYER_ID,PLAYER,VALUE,TOTAL DRV RANK,GIR RANK
1,0,21528,Henrik Stenson,2,1,1
2,0,34265,Will Wilcox,6,2,4
3,0,31557,Jim Herman,11,9,2
4,0,25364,Paul Casey,13,8,5
4,0,22405,Justin Rose,13,4,9
6,0,25900,Lucas Glover,21,11,10
7,0,27436,Graham DeLaet,27,5,22
8,0,24502,Adam Scott,31,15,16
9,0,32839,Hideki Matsuyama,33,12,21
10,0,29420,Billy Horschel,36,18,18
11,0,30946,Alex Prugh,40,29,11
11,0,26476,Chez Reavie,40,25,15
13,0,27214,Kevin Streelman,41,16,25
14,0,40026,Daniel Berger,48,18,30
15,0,25198,Francesco Molinari,49,43,6
15,0,34264,Hudson Swafford,49,10,39
17,0,29518,Brendan Steele,56,16,40
18,0,25686,Jason Dufner,58,34,24
19,0,36689,Brooks Koepka,59,42,17
19,0,33418,Shawn Stefani,59,27,32
21,0,33141,Keegan Bradley,63,3,60
21,0,25804,Bubba Watson,63,44,19
23,0,33122,Russell Knox,65,58,7
24,0,28089,Jason Day,67,60,7
25,0,33448,Justin Thomas,68,41,27
26,0,28780,Nicholas Thompson,69,33,36
27,0,35541,John Peterson,72,31,41
28,0,29221,Webb Simpson,73,20,53
29,0,24924,Bill Haas,75,44,31
30,0,34098,Russell Henley,76,7,69
30,0,34431,Robert Streb,76,53,23
32,0,26329,Louis Oosthuizen,77,34,43
33,0,01706,Davis Love III,78,14,64
34,0,10809,Jim Furyk,80,66,14
35,0,22892,Jason Gore,81,20,61
36,0,24024,Zach Johnson,86,49,37
37,0,27466,Spencer Levin,89,44,45
38,0,33413,Ben Martin,90,56,34
38,0,20645,John Senden,90,22,68
40,0,26951,Johnson Wagner,92,66,26
41,0,21209,Sergio Garcia,93,34,59
42,0,26289,Boo Weekley,94,39,55
43,0,37273,Derek Ernst,100,12,88
43,0,27933,John Merrick,100,44,56
45,0,34046,Jordan Spieth,101,52,49
46,0,23353,J.J. Henry,102,89,13
47,0,24507,Jason Bohn,108,80,28
48,0,12510,Chad Campbell,109,74,35
48,0,20691,Greg Owen,109,89,20
50,0,33667,Carlos Ortiz,112,38,74
51,0,27095,Nick Watney,119,53,66
52,0,36699,Patrick Rodgers,121,44,77
52,0,20396,Lee Westwood,121,32,89
54,0,24925,Jonathan Byrd,122,57,65
55,0,32334,Charlie Beljan,123,6,117
56,0,28486,Michael Putnam,124,112,12
57,0,23548,Bill Lunde,126,93,33
58,0,32102,Rickie Fowler,128,22,106
59,0,29478,Kevin Kisner,129,34,95
59,0,30944,Jason Kokrak,129,62,67
59,0,24361,Pat Perez,129,81,48
62,0,32366,Kevin Chappell,130,27,103
63,0,30925,Dustin Johnson,132,62,70
64,0,23320,Ryan Palmer,133,58,75
65,0,33399,Adam Hadwin,134,49,85
66,0,20229,Stewart Cink,135,132,3
67,0,34099,Harris English,139,69,70
67,0,29725,Tony Finau,139,82,57
67,0,31202,William McGirt,139,89,50
70,0,23638,Brendon de Jonge,140,78,62
71,0,28500,Martin Flores,142,101,41
72,0,27936,Martin Laird,145,51,94
73,0,27644,Brian Harman,147,66,81
73,0,30711,Colt Knost,147,84,63
75,0,25818,Scott Piercy,149,69,80
76,0,21961,Charles Howell III,150,112,38
76,0,31323,Gary Woodland,150,71,79
78,0,29223,Sam Saunders,151,26,125
79,0,26331,Charl Schwartzel,152,24,128
80,0,20771,Steven Alker,159,75,84
81,0,32448,James Hahn,160,62,98
81,0,34409,David Lingmerth,160,30,130
81,0,35451,Scott Pinckney,160,103,57
84,0,35545,Blayne Barber,165,75,90
85,0,12716,Charley Hoffman,168,71,97
86,0,23108,Matt Kuchar,169,84,85
87,0,22056,Cameron Percy,170,116,54
88,0,23621,Rory Sabbatini,171,119,52
88,0,28023,Byron Smith,171,143,28
90,0,26596,Ryan Moore,176,53,123
91,0,22046,Geoff Ogilvy,178,93,85
92,0,29535,Brice Garnett,183,140,43
92,0,24140,Sean O'Hair,183,39,144
94,0,24490,George McNeill,184,93,91
95,0,26758,David Hearn,185,138,47
96,0,08075,Jerry Kelly,186,82,104
97,0,23623,Bo Van Pelt,189,116,73
98,0,21878,Mark Wilson,191,140,51
99,0,24781,Hunter Mahan,194,87,107
100,0,29720,Andres Gonzales,195,114,81
101,0,36801,Mark Hubbard,197,122,75
102,0,29476,Kyle Reifers,199,127,72
103,0,26300,Matt Jones,207,60,147
104,0,34174,John Huh,210,78,132
105,0,06567,Vijay Singh,211,116,95
105,0,30927,Brendon Todd,211,93,118
107,0,33419,Cameron Tringale,212,75,137
108,0,25369,Jamie Donaldson,215,65,150
109,0,37454,Whee Kim,217,171,46
110,0,32200,Roberto Castro,218,119,99
110,0,24138,Ian Poulter,218,110,108
112,0,24358,Robert Garrigus,219,71,148
113,0,34130,Sung Joon Park,220,87,133
114,0,27064,Jhonattan Vegas,221,101,120
115,0,25632,Jimmy Walker,222,121,101
116,0,34262,Jon Curran,227,134,93
117,0,02206,David Toms,228,93,135
118,0,25892,Steve Wheatcroft,229,93,136
119,0,10885,Robert Allenby,230,149,81
120,0,29479,Scott Brown,231,105,126
121,0,35532,Tom Hoge,232,130,102
122,0,27963,Chris Stroud,234,122,112
123,0,40058,Zac Blair,238,122,116
123,0,27141,J.B. Holmes,238,84,154
125,0,20848,Ángel Cabrera,239,108,131
126,0,20472,Alex Cejka,241,132,109
126,0,29926,Danny Lee,241,130,111
128,0,23800,Bryce Molder,244,125,119
129,0,20104,Ken Duke,254,108,146
129,0,27649,Brandt Snedeker,254,125,129
131,0,25720,Chad Collins,256,156,100
131,0,30736,Oscar Fraustro,256,93,163
133,0,28132,Tyrone Van Aswegen,257,180,77
134,0,26851,Marc Leishman,260,147,113
135,0,30852,Ryo Ishikawa,262,170,92
136,0,25191,Gonzalo Fernandez-Castaño,264,115,149
136,0,10860,Justin Leonard,264,93,171
136,0,31560,Brian Stuard,264,103,161
139,0,29289,S.Y. Noh,265,160,105
139,0,25834,Daniel Summerhays,265,152,113
141,0,01810,Phil Mickelson,266,89,177
142,0,29222,Billy Hurley III,267,145,122
143,0,25274,Steven Bowditch,269,111,158
143,0,33486,Roger Sloan,269,105,164
145,0,30692,Scott Stallings,272,145,127
146,0,22293,Heath Slocum,274,105,169
147,0,32150,Michael Thompson,279,158,121
148,0,28475,Jeff Overton,281,172,109
149,0,30926,Chris Kirk,283,144,139
150,0,06522,Ernie Els,292,152,140
151,0,23983,Luke Donald,294,179,115
152,0,32640,Troy Merritt,295,136,159
153,0,28259,Sangmoon Bae,296,128,168
154,0,25493,Nick Taylor,297,155,142
155,0,23541,Ben Crane,298,138,160
156,0,31193,Jim Renner,299,176,123
157,0,25345,Carl Pettersson,300,134,166
158,0,21753,Brian Davis,302,128,174
158,0,25396,Kevin Na,302,164,138
160,0,34261,Scott Langley,303,169,134
160,0,34360,Patrick Reed,303,162,141
162,0,39977,Max Homa,304,137,167
163,0,34563,Chesson Hadley,308,152,156
164,0,24357,K.J. Choi,309,158,151
165,0,20593,Greg Chalmers,312,160,152
166,0,24494,Erik Compton,318,156,162
167,0,34358,Jonathan Randolph,319,176,143
168,0,33461,Morgan Hoffmann,320,140,180
169,0,27895,Jonas Blixt,321,151,170
169,0,29425,Andrew Svoboda,321,166,155
171,0,20157,Retief Goosen,322,147,175
172,0,28679,Fabián Gómez,324,167,157
173,0,25562,Andres Romero,325,149,176
174,0,35539,Luke Guthrie,327,174,153
174,0,25240,D.A. Points,327,182,145
176,0,27770,Camilo Villegas,333,168,165
177,0,25349,Tim Wilkinson,335,162,173
178,0,22371,Aaron Baddeley,337,165,172
179,0,31416,Derek Fathauer,353,175,178
180,0,20766,Padraig Harrington,354,173,181
181,0,23048,Eric Axley,357,178,179
182,0,28307,Matt Every,364,180,184
183,0,24846,Ricky Barnes,365,183,182
184,0,34256,Andrew Putnam,367,184,183