RANK,MOVEMENT,PLAYER_ID,PLAYER,TOTAL,DISTANCE RANK,ACCURACY RANK
1,0,08793,Tiger Woods,56,2,54
2,0,09011,David Duval,58,18,40
3,0,21209,Sergio Garcia,65,39,26
4,0,21805,Harrison Frazar,67,7,60
5,0,10885,Robert Allenby,75,10,65
6,0,01161,Mark Calcavecchia,86,31,55
7,0,06522,Ernie Els,89,38,51
8,0,01707,Steve Lowery,91,52,39
9,0,20095,Carl Paulson,92,14,78
10,0,02170,Hal Sutton,97,67,30
11,0,01943,Chris Perry,99,75,24
12,0,10425,Jay Williamson,106,63,43
13,0,01797,Rocco Mediate,108,88,20
14,0,06036,Scott Dunlap,109,78,31
15,0,01307,Joel Edwards,110,68,42
16,0,01418,Bill Glasson,115,27,88
17,0,01945,Kenny Perry,117,21,96
18,0,06621,Joe Durant,118,116,2
19,0,20094,Jonathan Kaye,121,71,50
19,0,01724,Jeff Maggert,121,105,16
21,0,12388,Michael Clark II,122,22,100
22,0,20574,Mathew Goggin,123,9,114
23,0,02206,David Toms,124,68,56
24,0,02214,Kirk Triplett,125,90,35
25,0,07457,Steve Flesch,126,32,94
26,0,01810,Phil Mickelson,130,3,127
27,0,20593,Greg Chalmers,134,42,92
27,0,01920,Craig Parry,134,122,12
27,0,01938,David Peoples,134,43,91
27,0,01968,Nick Price,134,97,37
31,0,01569,Peter Jacobsen,136,63,73
31,0,02245,Grant Waite,136,33,103
33,0,01706,Davis Love III,139,3,136
34,0,06567,Vijay Singh,142,30,112
35,0,01035,Tommy Armour III,144,28,116
35,0,19881,Robert Damron,144,34,110
35,0,12645,Brent Geiberger,144,86,58
38,0,23125,Brad Elder,146,56,90
38,0,02239,Scott Verplank,146,143,3
40,0,20043,Edward Fryatt,147,61,86
40,0,01577,Lee Janzen,147,83,64
42,0,10809,Jim Furyk,150,136,14
42,0,10860,Justin Leonard,150,105,45
44,0,01313,Steve Elkington,152,81,71
45,0,06251,Chris DiMarco,154,48,106
46,0,01408,Kelly Gibson,155,15,140
46,0,01677,Tom Lehman,155,103,52
48,0,01326,Nick Faldo,157,147,10
48,0,01975,Tom Purtzer,157,34,123
50,0,07867,Woody Austin,158,81,77
50,0,23614,Rich Beem,158,45,113
50,0,20445,Casey Martin,158,6,152
53,0,12660,Jesper Parnevik,159,93,66
54,0,01771,Blaine McCallister,160,140,20
55,0,24357,K.J. Choi,162,73,89
55,0,11032,Frank Lickliter II,162,139,23
55,0,06350,Bob May,162,57,105
58,0,01381,Fred Funk,163,162,1
59,0,01157,Tom Byrum,164,153,11
60,0,19824,Craig Barlow,165,24,141
60,0,12782,Tim Herron,165,12,153
62,0,01139,Olin Browne,166,160,6
62,0,01185,Brandel Chamblee,166,97,69
64,0,01761,Len Mattiace,167,97,70
65,0,10457,Frank Nobilo,168,127,41
66,0,20029,Notah Begay III,169,93,76
66,0,08375,Paul Stankowski,169,19,150
68,0,01388,Robert Gamez,170,126,44
69,0,06004,Stephen Ames,171,78,93
69,0,06575,Dudley Hart,171,110,61
69,0,01599,Steve Jones,171,41,130
72,0,01219,John Cook,172,143,29
72,0,01619,Skip Kendall,172,125,47
74,0,06809,Bob Burns,173,48,125
74,0,01766,Billy Mayfair,173,151,22
76,0,20098,Stuart Appleby,174,8,166
77,0,06581,David Sutherland,177,90,87
78,0,01527,Scott Hoch,178,131,47
78,0,08075,Jerry Kelly,178,80,98
78,0,06515,Shaun Micheel,178,52,126
78,0,01823,Larry Mize,178,173,5
78,0,02246,Duffy Waldorf,178,19,159
83,0,12680,Shigeki Maruyama,183,26,157
83,0,21949,Joe Ogilvie,183,54,129
85,0,01723,Andrew Magee,184,39,145
86,0,10585,Scott McCarron,185,5,180
87,0,24356,Jason Buha,186,75,111
87,0,07763,Doug Dunakey,186,37,149
89,0,19846,Brian Gay,187,170,17
90,0,08931,Glen Day,188,150,38
90,0,08993,Franklin Langham,188,93,95
92,0,12652,Cameron Beckman,189,29,160
92,0,06044,Scott Gump,189,182,7
92,0,23621,Rory Sabbatini,189,11,178
95,0,08545,Glen Hnatiuk,190,182,8
95,0,01553,John Huston,190,86,104
97,0,01249,John Daly,191,1,190
97,0,06573,Brandt Jobe,191,23,168
97,0,06315,Pete Jordan,191,182,9
100,0,20105,Jeff Gove,192,90,102
100,0,10649,Tom Scherrer,192,84,108
102,0,01142,Bart Bryant,194,176,18
102,0,01927,Dennis Paulson,194,15,179
102,0,02110,Jerry Smith,194,175,19
102,0,02279,Mark Wiebe,194,141,53
106,0,01014,Fulton Allem,195,168,27
106,0,01685,J.L. Lewis,195,34,161
106,0,01926,Steve Pate,195,127,68
109,0,01226,Fred Couples,196,13,183
109,0,01533,P.H. Horgan III,196,168,28
109,0,10962,Bradley Hughes,196,116,80
109,0,02010,Loren Roberts,196,192,4
109,0,02218,Ted Tryba,196,57,139
109,0,10423,Mike Weir,196,112,84
115,0,01042,Paul Azinger,198,50,148
115,0,10963,Jimmy Green,198,135,63
115,0,06062,Charles Raulerson,198,47,151
118,0,06617,Brian Henninger,199,116,83
119,0,10569,Mike Brisky,201,156,45
119,0,08547,John Maginnes,201,188,13
121,0,01191,Barry Cheesman,203,17,186
121,0,20127,Chris Riley,203,104,99
123,0,08243,Aaron Bengoechea,206,25,181
124,0,06140,Sean Murphy,208,123,85
125,0,20229,Stewart Cink,209,45,164
125,0,01996,Mike Reid,209,194,15
127,0,06643,Paul Goydos,212,179,33
128,0,06595,Kevin Sutherland,213,93,120
129,0,06078,Esteban Toledo,215,190,25
130,0,01063,Ben Bates,217,89,128
131,0,01376,Bob Friend,218,186,32
132,0,01320,Bob Estes,220,146,74
132,0,01374,Robin Freeman,220,73,147
132,0,06431,Jean Van de Velde,220,62,158
135,0,07363,Craig Bowden,223,187,36
135,0,22913,John Rollins,223,50,173
137,0,01098,Jay Don Blake,224,165,59
138,0,01132,Mark Brooks,226,177,49
138,0,21007,Gabriel Hjertstedt,226,119,107
140,0,01203,Russ Cochran,228,72,156
141,0,06012,Greg Kraft,229,154,75
141,0,01928,Corey Pavin,229,195,34
141,0,08385,Omar Uresti,229,157,72
144,0,02101,Joey Sindelar,230,97,133
145,0,02133,Craig Stadler,231,57,174
146,0,07749,Brett Quigley,232,57,175
147,0,19822,Bobby Cochran,234,65,169
148,0,10117,Bob Heintz,236,44,192
149,0,08537,J.P. Hayes,237,120,117
150,0,01261,Jay Delsing,239,85,154
150,0,21593,Keith Nolan,239,182,57
152,0,01905,Joe Ozaki,240,159,81
153,0,06088,Steve Gotsche,243,112,131
154,0,12753,David Morland IV,244,112,132
155,0,01457,Jay Haas,246,164,82
155,0,06527,Steve Stricker,246,55,191
157,0,01329,Brad Faxon,250,171,79
158,0,02257,Brian Watts,251,133,118
159,0,01941,Tom Pernice Jr.,254,130,124
160,0,01116,Michael Bradley,255,66,189
160,0,11653,Paul Curry,255,193,62
160,0,12823,Carlos Franco,255,68,187
160,0,01489,Steve Hart,255,188,67
160,0,06332,Neal Lancaster,255,112,143
165,0,10912,Craig Perks,257,102,155
166,0,01361,Dan Forsman,258,143,115
166,0,06090,Jim McGovern,258,123,135
168,0,02104,Jeff Sluman,264,167,97
169,0,20099,Doug Barron,269,147,122
170,0,01093,Ronnie Black,270,133,137
170,0,10213,Dicky Pride,270,161,109
170,0,06613,Tommy Tolles,270,75,195
173,0,22064,Craig Spence,273,97,176
174,0,23656,Jason Caron,275,105,170
174,0,11011,Mike Sposa,275,110,165
174,0,02223,Bob Tway,275,131,144
177,0,01024,Billy Andrade,277,105,172
178,0,01323,Brad Fabel,278,177,101
178,0,07101,Dave Stockton Jr.,278,157,121
180,0,01175,Jim Carter,282,163,119
181,0,10201,Matt Gogel,285,147,138
182,0,06014,Eric Booker,286,109,177
183,0,08045,Perry Moss,288,121,167
184,0,08535,Gary Nicklaus,305,142,163
185,0,12449,Ryan Howison,313,171,142
186,0,01331,Rick Fehr,314,129,185
186,0,01510,Nolan Henke,314,180,134
188,0,01378,David Frost,319,173,146
189,0,01282,Trevor Dodds,326,138,188
190,0,01040,Emlyn Aubrey,328,166,162
191,0,07753,Kevin Wentworth,330,137,193
192,0,01887,Mark O'Meara,336,152,184
193,0,02131,Mike Springer,337,155,182
194,0,01072,Chip Beck,362,191,171
195,0,01549,Mike Hulbert,375,181,194