RANK,MOVEMENT,PLAYER_ID,PLAYER,TOTAL,DISTANCE RANK,ACCURACY RANK
1,0,02170,Hal Sutton,62,58,4
2,0,09011,David Duval,66,6,60
3,0,02246,Duffy Waldorf,70,29,41
4,0,10962,Bradley Hughes,71,21,50
5,0,01968,Nick Price,72,53,19
6,0,01553,John Huston,77,25,52
7,0,06575,Dudley Hart,91,55,36
8,0,01771,Blaine McCallister,96,70,26
9,0,01361,Dan Forsman,100,49,51
10,0,01185,Brandel Chamblee,110,51,59
11,0,01706,Davis Love III,112,15,97
12,0,21584,Richie Coughlan,114,29,85
12,0,06621,Joe Durant,114,108,6
14,0,01599,Steve Jones,116,11,105
15,0,01063,Ben Bates,117,77,40
16,0,01408,Kelly Gibson,118,10,108
16,0,08793,Tiger Woods,118,2,116
18,0,01161,Mark Calcavecchia,119,28,91
19,0,12645,Brent Geiberger,120,52,68
20,0,19881,Robert Damron,121,27,94
21,0,01766,Billy Mayfair,124,92,32
22,0,01677,Tom Lehman,126,91,35
23,0,01035,Tommy Armour III,128,13,115
24,0,10809,Jim Furyk,130,110,20
25,0,02245,Grant Waite,132,37,95
26,0,07569,Mark Carnevale,133,111,22
26,0,01381,Fred Funk,133,126,7
26,0,01533,P.H. Horgan III,133,103,30
29,0,02002,John Riegger,135,90,45
30,0,01810,Phil Mickelson,136,9,127
31,0,08931,Glen Day,137,71,66
31,0,02133,Craig Stadler,137,57,80
33,0,01945,Kenny Perry,140,18,122
34,0,21805,Harrison Frazar,142,3,139
34,0,01527,Scott Hoch,142,117,25
36,0,01203,Russ Cochran,143,74,69
37,0,01577,Lee Janzen,144,45,99
38,0,01414,Bob Gilder,145,97,48
38,0,01619,Skip Kendall,145,106,39
38,0,02214,Kirk Triplett,145,131,14
41,0,01724,Jeff Maggert,146,143,3
42,0,02239,Scott Verplank,147,66,81
43,0,06567,Vijay Singh,149,20,129
44,0,01261,Jay Delsing,153,23,130
45,0,08375,Paul Stankowski,155,44,111
46,0,06643,Paul Goydos,156,133,23
46,0,01823,Larry Mize,156,154,2
48,0,01266,Clark Dennis,157,146,11
48,0,10860,Justin Leonard,157,128,29
50,0,01797,Rocco Mediate,158,88,70
51,0,06004,Stephen Ames,159,103,56
51,0,01723,Andrew Magee,159,55,104
53,0,06044,Scott Gump,160,152,8
54,0,01320,Bob Estes,161,106,55
55,0,06522,Ernie Els,162,42,120
56,0,01042,Paul Azinger,164,36,128
57,0,01157,Tom Byrum,165,155,10
57,0,10585,Scott McCarron,165,4,161
57,0,01941,Tom Pernice Jr.,165,31,134
60,0,10733,Kent Jones,166,95,71
61,0,20229,Stewart Cink,168,71,97
61,0,08993,Franklin Langham,168,82,86
61,0,01705,Tim Loustalot,168,163,5
61,0,02223,Bob Tway,168,50,118
65,0,07457,Steve Flesch,170,12,158
65,0,12782,Tim Herron,170,17,153
65,0,07749,Brett Quigley,170,33,137
68,0,01376,Bob Friend,171,155,16
69,0,01326,Nick Faldo,172,155,17
69,0,01388,Robert Gamez,172,108,64
69,0,20094,Jonathan Kaye,172,84,88
72,0,20099,Doug Barron,173,97,76
72,0,08075,Jerry Kelly,173,54,119
72,0,01707,Steve Lowery,173,33,140
72,0,01943,Chris Perry,173,89,84
76,0,01685,J.L. Lewis,174,15,159
76,0,02135,Mike Standly,174,60,114
78,0,11032,Frank Lickliter II,176,158,18
79,0,01334,Keith Fergus,178,40,138
80,0,01920,Craig Parry,179,100,79
81,0,20098,Stuart Appleby,180,25,155
81,0,19883,Joe Daley,180,146,34
83,0,01191,Barry Cheesman,181,7,174
83,0,02023,Clarence Rose,181,119,62
85,0,01226,Fred Couples,182,4,178
85,0,01353,Bruce Fleisher,182,181,1
85,0,01457,Jay Haas,182,145,37
88,0,01014,Fulton Allem,184,163,21
88,0,01569,Peter Jacobsen,184,39,145
88,0,06012,Greg Kraft,184,84,100
88,0,06090,Jim McGovern,184,61,123
88,0,02241,Bobby Wadkins,184,95,89
93,0,01306,David Edwards,185,172,13
94,0,08553,Lee Porter,186,177,9
94,0,02267,D.A. Weibring,186,174,12
96,0,01249,John Daly,187,1,186
97,0,06251,Chris DiMarco,188,76,112
97,0,06078,Esteban Toledo,188,173,15
97,0,02279,Mark Wiebe,188,113,75
100,0,01139,Olin Browne,189,162,27
100,0,01468,Gary Hallberg,189,19,170
100,0,02101,Joey Sindelar,189,97,92
100,0,02106,Chris Smith,189,14,175
104,0,02218,Ted Tryba,190,37,153
105,0,10207,Jimmy Johnston,191,149,42
105,0,01717,Sandy Lyle,191,43,148
107,0,01510,Nolan Henke,192,146,46
108,0,12755,Vance Veazey,193,8,185
109,0,02008,Lee Rinker,194,150,44
110,0,12660,Jesper Parnevik,197,140,57
111,0,08385,Omar Uresti,198,133,65
111,0,02321,Fuzzy Zoeller,198,167,31
113,0,01385,Jim Gallagher Jr.,201,21,180
114,0,19824,Craig Barlow,202,33,169
114,0,02010,Loren Roberts,202,178,24
114,0,06527,Steve Stricker,202,66,136
114,0,02206,David Toms,202,77,125
118,0,10195,Tim Conley,203,100,103
118,0,01604,Steve Jurgensen,203,93,110
120,0,01175,Jim Carter,204,151,53
120,0,21007,Gabriel Hjertstedt,204,83,121
122,0,01006,John Adams,205,24,181
123,0,01219,John Cook,206,163,43
124,0,08545,Glen Hnatiuk,207,135,72
125,0,06315,Pete Jordan,208,170,38
125,0,10457,Frank Nobilo,208,121,87
127,0,06617,Brian Henninger,209,45,164
128,0,01098,Jay Don Blake,211,135,76
128,0,02104,Jeff Sluman,211,138,73
130,0,01282,Trevor Dodds,213,47,166
130,0,08537,J.P. Hayes,213,64,149
132,0,01926,Steve Pate,214,81,133
132,0,06791,Mark Wurtz,214,113,101
134,0,06214,Guy Boros,215,75,140
134,0,01302,R.W. Eaks,215,32,183
134,0,07235,John Morse,215,187,28
134,0,02146,Payne Stewart,215,84,131
138,0,01905,Joe Ozaki,216,126,90
139,0,01891,David Ogrin,217,135,82
139,0,01996,Mike Reid,217,184,33
141,0,07101,Dave Stockton Jr.,222,66,156
142,0,01068,Andy Bean,223,47,176
142,0,01475,Donnie Hammond,223,121,102
142,0,01633,Tom Kite,223,140,83
142,0,08339,Spike McRoy,223,169,54
146,0,01096,Phil Blackmar,225,41,184
147,0,06332,Neal Lancaster,226,94,132
147,0,01748,Doug Martin,226,179,47
149,0,07707,Mike Small,227,121,106
150,0,07087,Hugh Royer III,229,62,167
151,0,01331,Rick Fehr,230,79,151
152,0,01960,Don Pooley,231,182,49
152,0,06132,Sonny Skinner,231,158,73
152,0,02159,Curtis Strange,231,171,60
152,0,10423,Mike Weir,231,79,152
156,0,01116,Michael Bradley,233,62,171
156,0,06270,Bobby Gage,233,166,67
158,0,10569,Mike Brisky,238,180,58
159,0,01093,Ronnie Black,241,73,168
160,0,02131,Mike Springer,242,69,173
161,0,01887,Mark O'Meara,243,117,126
161,0,07753,Kevin Wentworth,243,64,179
163,0,06613,Tommy Tolles,245,58,187
164,0,01132,Mark Brooks,246,129,117
165,0,06595,Kevin Sutherland,247,84,163
166,0,10213,Dicky Pride,248,185,63
167,0,02294,Willie Wood,251,175,76
168,0,01060,Dave Barr,252,143,109
168,0,06581,David Sutherland,252,102,150
170,0,01323,Brad Fabel,259,113,146
170,0,12663,Phil Tataurangi,259,124,135
172,0,01024,Billy Andrade,267,120,147
173,0,01607,Brian Kamm,269,112,157
174,0,21593,Keith Nolan,271,129,142
175,0,06064,Jeff Gallagher,274,131,143
176,0,01549,Mike Hulbert,275,103,172
177,0,02007,Larry Rinker,276,183,93
178,0,01329,Brad Faxon,280,167,113
179,0,01928,Corey Pavin,284,188,96
180,0,01761,Len Mattiace,285,161,124
181,0,01133,Billy Ray Brown,286,124,162
182,0,01201,Lennie Clements,293,186,107
183,0,21631,Iain Steel,298,116,182
184,0,06056,Jim Estes,299,139,160
185,0,20154,Guy Hill,317,140,177
186,0,01378,David Frost,318,153,165
187,0,02099,Scott Simpson,320,176,144
188,0,01072,Chip Beck,348,160,188