RANK,MOVEMENT,PLAYER_ID,PLAYER,VALUE,TOTAL DRV RANK,GIR RANK
1,0,02245,Grant Waite,9,5,4
2,0,02133,Craig Stadler,13,10,3
3,0,01569,Peter Jacobsen,15,3,12
3,0,02170,Hal Sutton,15,2,13
5,0,02256,Tom Watson,28,8,20
6,0,02214,Kirk Triplett,34,18,16
7,0,06044,Scott Gump,35,29,6
8,0,01677,Tom Lehman,36,27,9
8,0,02321,Fuzzy Zoeller,36,14,22
10,0,01313,Steve Elkington,42,15,27
11,0,02008,Lee Rinker,48,16,32
11,0,02246,Duffy Waldorf,48,21,27
13,0,01633,Tom Kite,52,35,17
13,0,01725,John Mahaffey,52,37,15
15,0,01690,Bruce Lietzke,53,6,47
16,0,12660,Jesper Parnevik,56,27,29
17,0,01837,Gil Morgan,62,43,19
18,0,01975,Tom Purtzer,67,57,10
19,0,01040,Emlyn Aubrey,69,55,14
19,0,09011,David Duval,69,9,60
19,0,01599,Steve Jones,69,51,18
22,0,01201,Lennie Clements,70,69,1
22,0,01418,Bill Glasson,70,7,63
22,0,01823,Larry Mize,70,47,23
22,0,06527,Steve Stricker,70,19,51
26,0,01326,Nick Faldo,71,36,35
26,0,02099,Scott Simpson,71,64,7
28,0,01132,Mark Brooks,72,47,25
29,0,01887,Mark O'Meara,74,66,8
30,0,01143,Brad Bryant,76,29,47
31,0,01035,Tommy Armour III,77,12,65
32,0,01226,Fred Couples,80,50,30
33,0,02239,Scott Verplank,84,39,45
34,0,01968,Nick Price,86,1,85
35,0,01006,John Adams,87,64,23
36,0,01381,Fred Funk,91,39,52
37,0,01876,Greg Norman,92,4,88
38,0,01706,Davis Love III,93,11,82
38,0,01890,Brett Ogle,93,54,39
40,0,01945,Kenny Perry,95,33,62
41,0,01142,Bart Bryant,97,95,2
42,0,02101,Joey Sindelar,98,87,11
42,0,02267,D.A. Weibring,98,62,36
44,0,01334,Keith Fergus,99,44,55
45,0,01161,Mark Calcavecchia,100,33,67
46,0,02223,Bob Tway,101,45,56
47,0,01723,Andrew Magee,102,59,43
48,0,01771,Blaine McCallister,103,21,82
49,0,10860,Justin Leonard,105,31,74
50,0,01098,Jay Don Blake,108,78,30
51,0,01766,Billy Mayfair,111,16,95
52,0,01175,Jim Carter,115,77,38
52,0,02104,Jeff Sluman,115,69,46
54,0,01810,Phil Mickelson,116,13,103
55,0,06124,Patrick Burke,117,96,21
55,0,01971,Dillard Pruitt,117,73,44
57,0,01361,Dan Forsman,121,80,41
57,0,01724,Jeff Maggert,121,20,101
59,0,02148,Ray Stewart,122,68,54
60,0,01306,David Edwards,124,75,49
60,0,01457,Jay Haas,124,51,73
62,0,06643,Paul Goydos,127,39,88
63,0,01475,Donnie Hammond,131,37,94
64,0,08337,Mike Heinen,133,74,59
64,0,01938,David Peoples,133,83,50
66,0,01577,Lee Janzen,136,31,105
66,0,02010,Loren Roberts,136,75,61
68,0,01385,Jim Gallagher Jr.,138,69,69
69,0,07867,Woody Austin,139,59,80
69,0,02159,Curtis Strange,139,55,84
71,0,07235,John Morse,146,78,68
72,0,01185,Brandel Chamblee,149,57,92
73,0,01060,Dave Barr,150,145,5
73,0,01707,Steve Lowery,150,87,63
73,0,01783,Mark McCumber,150,26,124
76,0,01203,Russ Cochran,151,117,34
77,0,01156,Curt Byrum,153,100,53
77,0,06567,Vijay Singh,153,47,106
79,0,06522,Ernie Els,156,23,133
80,0,06315,Pete Jordan,157,91,66
80,0,01905,Joe Ozaki,157,99,58
82,0,06090,Jim McGovern,158,89,69
83,0,01920,Craig Parry,159,62,97
84,0,02180,Harry Taylor,161,86,75
85,0,02190,Doug Tewell,162,83,79
86,0,07101,Dave Stockton Jr.,165,90,75
87,0,02241,Bobby Wadkins,166,109,57
88,0,01219,John Cook,168,142,26
89,0,06386,Bill Porter,169,46,123
90,0,01388,Robert Gamez,173,24,149
91,0,01960,Don Pooley,175,138,37
92,0,20094,Jonathan Kaye,180,42,138
93,0,01374,Robin Freeman,187,80,107
94,0,20051,Joe Acosta Jr.,188,117,71
95,0,06214,Guy Boros,192,107,85
96,0,01408,Kelly Gibson,194,83,111
96,0,01549,Mike Hulbert,194,161,33
96,0,02094,Tony Sills,194,155,39
99,0,01196,Brian Claar,197,66,131
99,0,06575,Dudley Hart,197,112,85
99,0,01553,John Huston,197,51,146
99,0,20095,Carl Paulson,197,24,173
103,0,02135,Mike Standly,199,82,117
104,0,01093,Ronnie Black,202,160,42
104,0,01353,Bruce Fleisher,202,103,99
106,0,06617,Brian Henninger,204,59,145
107,0,01986,Joey Rassett,205,130,75
108,0,01527,Scott Hoch,208,112,96
108,0,10215,Charlie Rymer,208,105,103
110,0,01928,Corey Pavin,212,112,100
110,0,06048,Dicky Thompson,212,119,93
112,0,02225,Howard Twitty,213,138,75
113,0,08375,Paul Stankowski,222,109,113
114,0,06034,Marco Dawson,223,152,71
114,0,10585,Scott McCarron,223,104,119
114,0,01891,David Ogrin,223,142,81
117,0,08385,Omar Uresti,228,126,102
118,0,01331,Rick Fehr,231,96,135
119,0,08931,Glen Day,232,105,127
120,0,10145,Tom Hearn,236,121,115
121,0,01748,Doug Martin,243,153,90
122,0,01797,Rocco Mediate,246,126,120
123,0,07569,Mark Carnevale,247,91,156
124,0,01864,Larry Nelson,248,91,157
124,0,02049,Gene Sauers,248,138,110
124,0,06577,John Wilson,248,150,98
127,0,02226,Tray Tyner,250,107,143
128,0,01014,Fulton Allem,252,69,183
128,0,01701,Bob Lohr,252,126,126
128,0,01996,Mike Reid,252,136,116
131,0,01266,Clark Dennis,254,132,122
132,0,01619,Skip Kendall,255,134,121
133,0,01116,Michael Bradley,256,112,144
134,0,01307,Joel Edwards,257,166,91
135,0,01042,Paul Azinger,258,150,108
135,0,02111,Mike Smith,258,111,147
137,0,01607,Brian Kamm,259,96,163
138,0,01550,Ed Humenik,262,126,136
138,0,01705,Tim Loustalot,262,112,150
140,0,01927,Dennis Paulson,268,100,168
141,0,01329,Brad Faxon,275,122,153
141,0,01682,Wayne Levi,275,133,142
141,0,06613,Tommy Tolles,275,134,141
141,0,08563,Bruce Vaughan,275,147,128
141,0,10425,Jay Williamson,275,100,175
146,0,01249,John Daly,276,91,185
147,0,01072,Chip Beck,277,153,124
147,0,01685,J.L. Lewis,277,147,130
149,0,07721,Pat Bates,278,130,148
150,0,01510,Nolan Henke,282,142,140
151,0,01320,Bob Estes,286,157,129
152,0,01925,Jerry Pate,287,122,165
153,0,08717,Kawika Cotner,289,172,117
153,0,02218,Ted Tryba,289,120,169
155,0,01133,Billy Ray Brown,291,182,109
156,0,01992,Don Reese,294,180,114
156,0,02146,Payne Stewart,294,124,170
158,0,01024,Billy Andrade,298,186,112
159,0,01414,Bob Gilder,300,124,176
160,0,01096,Phil Blackmar,301,147,154
161,0,01444,Ken Green,302,165,137
162,0,06088,Steve Gotsche,305,145,160
163,0,01458,Jerry Haas,308,156,152
163,0,06332,Neal Lancaster,308,136,172
165,0,01926,Steve Pate,310,177,133
166,0,01261,Jay Delsing,312,141,171
167,0,02242,Lanny Wadkins,319,187,132
168,0,01235,Ben Crenshaw,323,164,159
169,0,10809,Jim Furyk,324,163,161
170,0,06809,Bob Burns,325,167,158
171,0,06197,Michael Allen,326,162,164
171,0,01129,Bill Britton,326,188,138
171,0,01943,Chris Perry,326,175,151
174,0,08537,J.P. Hayes,330,168,162
175,0,02167,Mike Sullivan,332,177,155
176,0,10569,Mike Brisky,334,157,177
177,0,06657,Steve Rintoul,337,171,166
178,0,01378,David Frost,338,157,181
179,0,06251,Chris DiMarco,343,176,167
180,0,06012,Greg Kraft,347,173,174
181,0,10213,Dicky Pride,349,169,180
182,0,02279,Mark Wiebe,352,174,178
183,0,01330,David Feherty,357,170,187
184,0,01468,Gary Hallberg,359,177,182
185,0,06791,Mark Wurtz,363,184,179
186,0,06641,Jeff Leonard,367,183,184
187,0,02131,Mike Springer,369,181,188
188,0,01200,Keith Clearwater,371,185,186