YEAR,MOVEMENT,PLAYER_ID,PLAYER,TOTAL,DISTANCE RANK,ACCURACY RANK
2024,0,51696,Rico Hoey,83,25,58
2024,0,46046,Scottie Scheffler,87,64,23
2024,0,52372,Cameron Champ,94,1,93
2024,0,52955,Ludvig Åberg,96,22,74
2024,0,54576,Patrick Fishburn,98,30,68
2024,0,28237,Rory McIlroy,104,2,102
2024,0,30911,Tommy Fleetwood,108,97,11
2024,0,57362,Austin Eckroat,109,93,16
2024,0,46340,Alex Smalley,111,38,73
2024,0,34046,Jordan Spieth,115,43,72
2024,0,60067,Joe Highsmith,116,46,70
2024,0,34099,Harris English,120,83,37
2024,0,36799,Stephan Jaeger,122,21,101
2024,0,40026,Daniel Berger,123,118,5
2024,0,33141,Keegan Bradley,124,54,70
2024,0,32333,Kevin Tway,124,49,75
2024,0,47504,Sam Burns,126,39,87
2024,0,33204,Shane Lowry,126,97,29
2024,0,48867,Matti Schmid,126,35,91
2024,0,48081,Xander Schauffele,128,33,95
2024,0,58168,Davis Thompson,129,47,82
2024,0,34587,Chan Kim,130,85,45
2024,0,50484,Hayden Springer,134,16,118
2024,0,35310,Lanto Griffin,135,58,77
2024,0,30926,Chris Kirk,136,103,33
2024,0,27064,Jhonattan Vegas,137,9,128
2024,0,56630,Akshay Bhatia,138,104,34
2024,0,39997,Corey Conners,140,90,50
2024,0,39546,Keith Mitchell,140,14,126
2024,0,52513,Carson Young,140,136,4
2024,0,51977,Max Greyserman,142,17,125
2024,0,50525,Collin Morikawa,142,135,7
2024,0,57366,Cameron Young,142,29,113
2024,0,52375,Doug Ghim,143,129,14
2024,0,32791,K.H. Lee,143,83,60
2024,0,40006,Erik van Rooyen,144,35,109
2024,0,45609,Tyler Duncan,145,124,21
2024,0,28252,Seamus Power,145,99,46
2024,0,55454,Carl Yuan,145,23,122
2024,0,32757,Patton Kizzire,148,87,61
2024,0,50095,Austin Smotherman,148,104,44
2024,0,45242,Kevin Yu,148,37,111
2024,0,59836,Pierceson Coody,149,13,136
2024,0,59143,Mac Meissner,149,71,78
2024,0,46717,Viktor Hovland,152,55,97
2024,0,48117,Kurt Kitayama,153,32,121
2024,0,55182,Tom Kim,154,111,43
2024,0,37378,Min Woo Lee,154,7,147
2024,0,23320,Ryan Palmer,154,113,41
2024,0,46414,Aaron Rai,154,153,1
2024,0,49960,Sepp Straka,154,146,8
2024,0,55708,Hayden Buckley,155,120,35
2024,0,54628,Lee Hodges,156,132,24
2024,0,48153,Matthieu Pavon,156,92,64
2024,0,30163,Henrik Norlander,157,142,15
2024,0,51070,Vincent Norrman,157,17,140
2024,0,37212,Paul Barjon,158,12,146
2024,0,40250,Taylor Pendrith,158,10,148
2024,0,45157,Cam Davis,159,69,90
2024,0,40115,Adam Svensson,159,128,31
2024,0,29420,Billy Horschel,161,107,54
2024,0,47663,Kevin Dougherty,162,4,158
2024,0,50493,Justin Suh,162,100,62
2024,0,37455,Si Woo Kim,165,145,20
2024,0,46442,Maverick McNealy,165,77,88
2024,0,34076,Joel Dahmen,166,149,17
2024,0,55893,Sam Stevens,166,47,119
2024,0,36884,Ben Kohles,167,165,2
2024,0,32070,Rafael Campos,169,64,105
2024,0,34563,Chesson Hadley,170,56,114
2024,0,39971,Sungjae Im,170,113,57
2024,0,48319,Tom Whitney,170,133,37
2024,0,28420,Ryan Brehm,171,28,143
2024,0,36801,Mark Hubbard,171,146,25
2024,0,51766,Wyndham Clark,172,8,164
2024,0,29725,Tony Finau,172,34,138
2024,0,49947,Taylor Moore,172,45,127
2024,0,39324,J.J. Spaun,172,88,84
2024,0,34098,Russell Henley,173,164,9
2024,0,36871,Matt NeSmith,173,121,52
2024,0,27330,Josh Teater,173,118,55
2024,0,48084,Wesley Bryan,175,75,100
2024,0,40098,Matt Fitzpatrick,175,111,64
2024,0,36699,Patrick Rodgers,175,51,124
2024,0,27214,Kevin Streelman,175,126,49
2024,0,34255,Joseph Bramlett,176,17,159
2024,0,29535,Brice Garnett,176,173,3
2024,0,51349,Nico Echavarria,179,140,39
2024,0,47988,Nick Hardy,179,60,119
2024,0,27644,Brian Harman,179,160,19
2024,0,28775,Nate Lashley,179,157,22
2024,0,33948,Byeong Hun An,180,3,177
2024,0,25900,Lucas Glover,180,170,10
2024,0,54421,Garrick Higgo,180,30,150
2024,0,26596,Ryan Moore,180,174,6
2024,0,24502,Adam Scott,180,41,139
2024,0,31323,Gary Woodland,180,11,169
2024,0,47420,Jake Knapp,181,24,157
2024,0,28089,Jason Day,182,93,89
2024,0,51634,Sahith Theegala,182,53,129
2024,0,47483,Will Zalatoris,183,77,106
2024,0,35461,Beau Hossler,184,73,111
2024,0,32640,Troy Merritt,185,158,27
2024,0,47347,Adam Schenk,185,81,104
2024,0,33448,Justin Thomas,186,26,160
2024,0,38991,Alejandro Tosti,186,6,180
2024,0,59095,Chris Gotterup,188,5,183
2024,0,26476,Chez Reavie,188,176,12
2024,0,37275,Sam Ryder,188,158,30
2024,0,56149,Wilson Furr,189,15,174
2024,0,22405,Justin Rose,189,126,63
2024,0,51890,Greyson Sigg,189,149,40
2024,0,34021,Bud Cauley,190,106,84
2024,0,52514,Trace Crowe,191,85,106
2024,0,49771,J.T. Poston,191,156,35
2024,0,27349,Alex Noren,192,139,53
2024,0,57900,Chandler Phillips,192,144,48
2024,0,27129,Luke List,193,59,134
2024,0,47983,Chad Ramey,193,151,42
2024,0,47679,Victor Perez,194,91,103
2024,0,29908,C.T. Pan,195,148,47
2024,0,33653,Thomas Detry,197,67,130
2024,0,30927,Brendon Todd,197,184,13
2024,0,40058,Zac Blair,198,180,18
2024,0,12716,Charley Hoffman,198,61,137
2024,0,51287,Ryo Hisatsune,199,140,59
2024,0,52453,Nicolai Højgaard,199,26,173
2024,0,29936,Ryan Fox,202,20,182
2024,0,23108,Matt Kuchar,202,174,28
2024,0,59866,Nick Dunlap,204,40,164
2024,0,33399,Adam Hadwin,204,124,80
2024,0,24024,Zach Johnson,204,178,26
2024,0,33486,Roger Sloan,205,154,51
2024,0,35450,Patrick Cantlay,208,73,135
2024,0,60004,Jacob Bridgeman,210,96,114
2024,0,52215,Robert MacIntyre,210,57,153
2024,0,32366,Kevin Chappell,211,95,116
2024,0,39975,Michael Kim,211,70,141
2024,0,50188,S.H. Kim,213,62,151
2024,0,32367,Jorge Campillo,214,131,83
2024,0,34256,Andrew Putnam,214,183,31
2024,0,31646,Emiliano Grillo,217,161,56
2024,0,60767,Blaine Hale Jr.,217,41,176
2024,0,46113,Ryan McCormick,217,49,168
2024,0,39327,Ben Silverman,218,151,67
2024,0,52666,Sami Valimaki,218,110,108
2024,0,32102,Rickie Fowler,220,121,99
2024,0,47995,Davis Riley,220,66,154
2024,0,48699,Callum Tarren,222,43,179
2024,0,33408,Tyson Alexander,223,67,156
2024,0,51894,Vince Whaley,223,52,171
2024,0,54783,Dylan Wu,228,136,92
2024,0,35532,Tom Hoge,230,134,96
2024,0,29221,Webb Simpson,231,100,131
2024,0,57975,Harry Hall,233,88,145
2024,0,47993,Denny McCarthy,236,167,69
2024,0,50497,Adrien Dumont de Chassart,237,75,162
2024,0,27139,David Skinns,237,71,166
2024,0,36326,David Lipsky,238,172,66
2024,0,32839,Hideki Matsuyama,239,107,132
2024,0,59442,Parker Coody,240,62,178
2024,0,25493,Nick Taylor,240,154,86
2024,0,40162,Justin Lower,241,143,98
2024,0,33968,Thorbjørn Olesen,244,81,163
2024,0,52374,Brandon Wu,244,163,81
2024,0,35617,Martin Trainer,247,80,167
2024,0,51997,Andrew Novak,248,115,133
2024,0,34374,Erik Barnes,254,79,175
2024,0,39977,Max Homa,254,100,154
2024,0,29478,Kevin Kisner,257,181,76
2024,0,54591,Ben Griffin,259,136,123
2024,0,27649,Brandt Snedeker,261,182,79
2024,0,27936,Martin Laird,262,168,94
2024,0,46441,Robby Shelton,272,162,110
2024,0,48887,Matt Wallace,276,115,161
2024,0,47591,Eric Cole,278,129,149
2024,0,48119,Ben Taylor,279,107,172
2024,0,45522,Christiaan Bezuidenhout,282,166,116
2024,0,35506,Mackenzie Hughes,287,117,170
2024,0,34466,Peter Malnati,302,121,181
2024,0,22371,Aaron Baddeley,321,179,142
2024,0,47806,Raul Pereda,321,169,152
2024,0,27770,Camilo Villegas,321,177,144
2024,0,55789,Taylor Montgomery,355,171,184
2023,0,52955,Ludvig Åberg,33,6,27
2023,0,39546,Keith Mitchell,62,14,48
2023,0,35450,Patrick Cantlay,63,37,26
2023,0,51414,Brent Grant,68,25,43
2023,0,46717,Viktor Hovland,84,44,40
2023,0,58696,Peter Kuest,84,2,82
2023,0,56762,Will Gordon,91,21,70
2023,0,55708,Hayden Buckley,94,65,29
2023,0,46046,Scottie Scheffler,95,31,64
2023,0,45242,Kevin Yu,96,23,73
2023,0,56630,Akshay Bhatia,97,59,38
2023,0,52372,Cameron Champ,99,4,95
2023,0,48867,Matti Schmid,105,10,95
2023,0,33204,Shane Lowry,108,71,37
2023,0,57366,Cameron Young,113,7,106
2023,0,58168,Davis Thompson,121,31,90
2023,0,57362,Austin Eckroat,123,88,35
2023,0,35310,Lanto Griffin,123,81,42
2023,0,45609,Tyler Duncan,128,115,13
2023,0,52375,Doug Ghim,129,119,10
2023,0,55182,Tom Kim,133,121,12
2023,0,28089,Jason Day,134,66,68
2023,0,31323,Gary Woodland,134,13,121
2023,0,51070,Vincent Norrman,136,9,127
2023,0,49960,Sepp Straka,138,105,33
2023,0,46970,Jon Rahm,140,11,129
2023,0,37455,Si Woo Kim,141,130,11
2023,0,50525,Collin Morikawa,142,134,8
2023,0,39067,MJ Daffue,145,29,116
2023,0,32448,James Hahn,145,114,31
2023,0,30911,Tommy Fleetwood,148,81,67
2023,0,31577,Tano Goya,148,77,71
2023,0,34363,Tyrrell Hatton,149,48,101
2023,0,50095,Austin Smotherman,150,94,56
2023,0,25900,Lucas Glover,151,146,5
2023,0,29725,Tony Finau,152,66,86
2023,0,32102,Rickie Fowler,152,39,113
2023,0,23320,Ryan Palmer,153,87,66
2023,0,39977,Max Homa,155,62,93
2023,0,50493,Justin Suh,155,108,47
2023,0,39324,J.J. Spaun,156,115,41
2023,0,46414,Aaron Rai,157,151,6
2023,0,47504,Sam Burns,159,21,138
2023,0,54421,Garrick Higgo,160,27,133
2023,0,47995,Davis Riley,160,52,108
2023,0,39971,Sungjae Im,162,110,52
2023,0,31646,Emiliano Grillo,165,86,79
2023,0,29221,Webb Simpson,165,103,62
2023,0,47988,Nick Hardy,166,34,132
2023,0,52513,Carson Young,167,142,25
2023,0,33141,Keegan Bradley,168,54,114
2023,0,34098,Russell Henley,169,168,1
2023,0,39997,Corey Conners,170,92,78
2023,0,39975,Michael Kim,170,58,112
2023,0,51766,Wyndham Clark,171,15,156
2023,0,33653,Thomas Detry,171,43,128
2023,0,27644,Brian Harman,172,156,16
2023,0,29420,Billy Horschel,172,117,55
2023,0,28237,Rory McIlroy,172,1,171
2023,0,40115,Adam Svensson,173,134,39
2023,0,36724,Augusto Núñez,175,33,142
2023,0,55893,Sam Stevens,175,28,147
2023,0,49298,Kramer Hickok,176,131,45
2023,0,36799,Stephan Jaeger,176,50,126
2023,0,50188,S.H. Kim,176,36,140
2023,0,45157,Cam Davis,177,26,151
2023,0,32640,Troy Merritt,178,158,20
2023,0,49453,Trevor Cone,179,11,168
2023,0,40250,Taylor Pendrith,179,30,149
2023,0,40006,Erik van Rooyen,181,59,122
2023,0,35449,Adam Long,182,168,14
2023,0,27129,Luke List,183,23,160
2023,0,32816,Satoshi Kodaira,184,181,3
2023,0,39954,Cody Gribble,186,99,87
2023,0,33399,Adam Hadwin,186,140,46
2023,0,27936,Martin Laird,186,164,22
2023,0,26596,Ryan Moore,186,182,4
2023,0,33948,Byeong Hun An,187,8,179
2023,0,34076,Joel Dahmen,187,136,51
2023,0,35461,Beau Hossler,187,57,130
2023,0,24502,Adam Scott,187,17,170
2023,0,46340,Alex Smalley,187,78,109
2023,0,36871,Matt NeSmith,188,128,60
2023,0,19803,Ryan Armour,189,187,2
2023,0,54628,Lee Hodges,189,95,94
2023,0,34099,Harris English,190,125,65
2023,0,31557,Jim Herman,190,172,18
2023,0,24024,Zach Johnson,190,171,19
2023,0,32791,K.H. Lee,190,91,99
2023,0,49947,Taylor Moore,191,46,145
2023,0,52453,Nicolai Hojgaard,192,5,187
2023,0,33448,Justin Thomas,192,38,154
2023,0,39335,Kevin Roy,194,75,119
2023,0,51491,Brandon Matthews,195,3,192
2023,0,23108,Matt Kuchar,196,147,49
2023,0,40058,Zac Blair,197,190,7
2023,0,35879,Kelly Kraft,197,180,17
2023,0,12716,Charley Hoffman,198,50,148
2023,0,22405,Justin Rose,198,144,54
2023,0,30927,Brendon Todd,198,189,9
2023,0,34255,Joseph Bramlett,199,18,181
2023,0,26476,Chez Reavie,199,178,21
2023,0,36699,Patrick Rodgers,199,35,164
2023,0,48081,Xander Schauffele,199,68,131
2023,0,48699,Callum Tarren,204,19,185
2023,0,51349,Nico Echavarria,206,108,98
2023,0,40098,Matt Fitzpatrick,206,68,138
2023,0,52411,Kyle Westmoreland,206,15,191
2023,0,34409,David Lingmerth,207,192,15
2023,0,29908,C.T. Pan,207,132,75
2023,0,47347,Adam Schenk,207,54,153
2023,0,54783,Dylan Wu,207,118,89
2023,0,28252,Seamus Power,208,98,110
2023,0,29535,Brice Garnett,209,177,32
2023,0,35901,Paul Haley II,209,186,23
2023,0,28775,Nate Lashley,209,124,85
2023,0,46601,Trey Mullinax,209,20,189
2023,0,52374,Brandon Wu,209,140,69
2023,0,55454,Carl Yuan,209,47,162
2023,0,39058,Lucas Herbert,210,64,146
2023,0,33413,Ben Martin,211,154,57
2023,0,34046,Jordan Spieth,211,74,137
2023,0,47128,Richy Werenski,211,93,118
2023,0,27554,Scott Harrington,212,39,173
2023,0,30926,Chris Kirk,212,133,79
2023,0,36326,David Lipsky,212,162,50
2023,0,33410,Andrew Landry,214,178,36
2023,0,32757,Patton Kizzire,215,90,125
2023,0,31202,William McGirt,215,191,24
2023,0,51890,Greyson Sigg,215,138,77
2023,0,32333,Kevin Tway,215,39,176
2023,0,46435,Austin Cook,216,188,28
2023,0,47993,Denny McCarthy,216,143,73
2023,0,24140,Sean O'Hair,217,159,58
2023,0,22056,Cameron Percy,217,173,44
2023,0,49771,J.T. Poston,217,129,88
2023,0,34256,Andrew Putnam,218,184,34
2023,0,53165,Doc Redman,218,157,61
2023,0,51997,Andrew Novak,219,102,117
2023,0,47079,Harrison Endycott,220,161,59
2023,0,27214,Kevin Streelman,222,125,97
2023,0,31560,Brian Stuard,223,193,30
2023,0,25632,Jimmy Walker,223,45,178
2023,0,35617,Martin Trainer,224,83,141
2023,0,34610,Matthias Schwab,225,153,72
2023,0,59018,Ryan Gerard,226,119,107
2023,0,28420,Ryan Brehm,227,39,188
2023,0,32839,Hideki Matsuyama,227,127,100
2023,0,30163,Henrik Norlander,228,165,63
2023,0,20229,Stewart Cink,230,56,174
2023,0,34563,Chesson Hadley,230,110,120
2023,0,30692,Scott Stallings,231,88,143
2023,0,51634,Sahith Theegala,231,59,172
2023,0,48117,Kurt Kitayama,232,49,183
2023,0,49766,Hank Lebioda,232,121,111
2023,0,55789,Taylor Montgomery,232,71,161
2023,0,47983,Chad Ramey,232,148,84
2023,0,32366,Kevin Chappell,234,84,150
2023,0,25686,Jason Dufner,236,112,124
2023,0,33122,Russell Knox,236,183,53
2023,0,48887,Matt Wallace,236,79,157
2023,0,58967,Trevor Werbylo,237,53,184
2023,0,32662,Michael Gligic,238,63,175
2023,0,37338,Zecheng Dou,239,80,159
2023,0,35532,Tom Hoge,240,137,103
2023,0,54591,Ben Griffin,241,97,144
2023,0,45522,Christiaan Bezuidenhout,242,167,75
2023,0,36801,Mark Hubbard,246,163,83
2023,0,29289,S.Y. Noh,249,73,176
2023,0,25818,Scott Piercy,250,159,91
2023,0,27349,Alex Noren,251,96,155
2023,0,33597,Harry Higgs,252,85,167
2023,0,40162,Justin Lower,252,150,102
2023,0,24925,Jonathan Byrd,254,173,81
2023,0,48119,Ben Taylor,254,68,186
2023,0,46441,Robby Shelton,256,151,105
2023,0,35506,Mackenzie Hughes,257,105,152
2023,0,46442,Maverick McNealy,257,99,158
2023,0,34431,Robert Streb,257,121,136
2023,0,57975,Harry Hall,266,101,165
2023,0,27963,Chris Stroud,267,175,92
2023,0,48084,Wesley Bryan,269,103,166
2023,0,29970,Dylan Frittelli,269,76,193
2023,0,25493,Nick Taylor,269,155,114
2023,0,51950,Max McGreevy,273,170,103
2023,0,33408,Tyson Alexander,274,105,169
2023,0,47591,Eric Cole,276,113,163
2023,0,37275,Sam Ryder,283,148,135
2023,0,32139,Danny Willett,289,166,123
2023,0,22371,Aaron Baddeley,319,185,134
2023,0,34466,Peter Malnati,326,144,182
2023,0,27095,Nick Watney,328,138,190
2023,0,27974,Sung Kang,356,176,180
2022,0,46970,Jon Rahm,61,5,56
2022,0,39546,Keith Mitchell,91,18,73
2022,0,48081,Xander Schauffele,95,35,60
2022,0,39997,Corey Conners,98,78,20
2022,0,39971,Sungjae Im,98,71,27
2022,0,31646,Emiliano Grillo,99,58,41
2022,0,46717,Viktor Hovland,107,37,70
2022,0,47995,Davis Riley,110,43,67
2022,0,50525,Collin Morikawa,112,83,29
2022,0,55708,Hayden Buckley,113,98,15
2022,0,30944,Jason Kokrak,116,32,84
2022,0,50095,Austin Smotherman,116,63,53
2022,0,46046,Scottie Scheffler,119,19,100
2022,0,34098,Russell Henley,120,106,14
2022,0,40098,Matt Fitzpatrick,121,70,51
2022,0,27936,Martin Laird,121,111,10
2022,0,29518,Brendan Steele,123,42,81
2022,0,45526,Abraham Ancer,124,120,4
2022,0,57366,Cameron Young,125,3,122
2022,0,25900,Lucas Glover,128,115,13
2022,0,47856,Seth Reeves,128,27,101
2022,0,29221,Webb Simpson,128,94,34
2022,0,28237,Rory McIlroy,129,2,127
2022,0,33204,Shane Lowry,131,49,82
2022,0,35450,Patrick Cantlay,133,40,93
2022,0,52372,Cameron Champ,133,1,132
2022,0,46402,Talor Gooch,133,64,69
2022,0,37455,Si Woo Kim,134,92,42
2022,0,30926,Chris Kirk,134,98,36
2022,0,34264,Hudson Swafford,135,45,90
2022,0,21961,Charles Howell III,137,66,71
2022,0,48822,Sebastián Muñoz,137,71,66
2022,0,27214,Kevin Streelman,137,131,6
2022,0,32791,K.H. Lee,140,79,61
2022,0,39977,Max Homa,144,52,92
2022,0,46340,Alex Smalley,144,50,94
2022,0,37212,Paul Barjon,146,27,119
2022,0,29420,Billy Horschel,147,116,31
2022,0,40250,Taylor Pendrith,147,10,137
2022,0,33141,Keegan Bradley,148,44,104
2022,0,45609,Tyler Duncan,148,140,8
2022,0,46414,Aaron Rai,151,135,16
2022,0,49947,Taylor Moore,153,80,73
2022,0,49964,Aaron Wise,154,39,115
2022,0,32448,James Hahn,155,77,78
2022,0,36871,Matthew NeSmith,155,111,44
2022,0,20229,Stewart Cink,156,53,103
2022,0,32102,Rickie Fowler,158,27,131
2022,0,33399,Adam Hadwin,161,117,44
2022,0,47529,Mito Pereira,164,69,95
2022,0,31323,Gary Woodland,164,23,141
2022,0,28252,Seamus Power,165,93,72
2022,0,36326,David Lipsky,168,138,30
2022,0,29725,Tony Finau,169,40,129
2022,0,29535,Brice Garnett,169,152,17
2022,0,52375,Doug Ghim,171,133,38
2022,0,49298,Kramer Hickok,171,146,25
2022,0,33122,Russell Knox,171,152,19
2022,0,54628,Lee Hodges,172,97,75
2022,0,32839,Hideki Matsuyama,172,62,110
2022,0,27064,Jhonattan Vegas,172,11,161
2022,0,47483,Will Zalatoris,172,13,159
2022,0,34076,Joel Dahmen,173,161,12
2022,0,31557,Jim Herman,173,164,9
2022,0,28089,Jason Day,174,87,87
2022,0,31420,Anirban Lahiri,175,107,68
2022,0,46442,Maverick McNealy,175,45,130
2022,0,46601,Trey Mullinax,175,9,166
2022,0,27129,Luke List,177,12,165
2022,0,45486,Joaquin Niemann,178,34,144
2022,0,24502,Adam Scott,178,15,163
2022,0,49960,Sepp Straka,178,76,102
2022,0,27644,Brian Harman,180,159,21
2022,0,45540,Jared Wolfe,180,24,156
2022,0,51766,Wyndham Clark,181,4,177
2022,0,33448,Justin Thomas,181,14,167
2022,0,40006,Erik van Rooyen,182,103,79
2022,0,30978,Kiradech Aphibarnrat,183,155,28
2022,0,29908,C.T. Pan,183,124,59
2022,0,39324,J.J. Spaun,184,145,39
2022,0,34255,Joseph Bramlett,185,7,178
2022,0,28775,Nate Lashley,185,138,47
2022,0,47504,Sam Burns,186,24,162
2022,0,35532,Tom Hoge,186,110,76
2022,0,34174,John Huh,186,163,23
2022,0,32816,Satoshi Kodaira,186,184,2
2022,0,19803,Ryan Armour,187,186,1
2022,0,34046,Jordan Spieth,187,37,150
2022,0,48887,Matt Wallace,188,71,117
2022,0,45157,Cam Davis,189,35,154
2022,0,47988,Nick Hardy,189,56,133
2022,0,22405,Justin Rose,190,102,88
2022,0,36689,Brooks Koepka,192,17,175
2022,0,40115,Adam Svensson,194,154,40
2022,0,32139,Danny Willett,194,117,77
2022,0,51890,Greyson Sigg,195,141,54
2022,0,35879,Kelly Kraft,196,175,21
2022,0,26476,Chez Reavie,196,191,5
2022,0,31560,Brian Stuard,196,193,3
2022,0,48699,Callum Tarren,196,15,181
2022,0,29478,Kevin Kisner,197,171,26
2022,0,35449,Adam Long,198,165,33
2022,0,24138,Ian Poulter,198,133,65
2022,0,56278,Matthew Wolff,198,6,192
2022,0,54421,Garrick Higgo,199,61,138
2022,0,26851,Marc Leishman,199,48,151
2022,0,30927,Brendon Todd,199,192,7
2022,0,48117,Kurt Kitayama,200,20,180
2022,0,23320,Ryan Palmer,200,58,142
2022,0,23325,Vaughn Taylor,200,189,11
2022,0,52374,Brandon Wu,200,137,63
2022,0,30911,Tommy Fleetwood,201,89,112
2022,0,46550,Brandon Hagy,201,8,193
2022,0,47993,Denny McCarthy,202,165,37
2022,0,32640,Troy Merritt,202,159,43
2022,0,34431,Robert Streb,202,96,106
2022,0,32150,Michael Thompson,202,178,24
2022,0,32662,Michael Gligic,203,90,113
2022,0,32366,Kevin Chappell,205,22,183
2022,0,46435,Austin Cook,205,187,18
2022,0,33419,Cameron Tringale,205,82,123
2022,0,47983,Chad Ramey,208,176,32
2022,0,10381,Curtis Thompson,208,32,176
2022,0,32333,Kevin Tway,208,21,187
2022,0,35461,Beau Hossler,209,30,179
2022,0,49766,Hank Lebioda,210,147,63
2022,0,35310,Lanto Griffin,211,87,124
2022,0,12716,Charley Hoffman,214,24,190
2022,0,28114,Dawie van der Walt,214,107,107
2022,0,33667,Carlos Ortiz,215,75,140
2022,0,49771,J.T. Poston,215,107,108
2022,0,47347,Adam Schenk,215,68,147
2022,0,36699,Patrick Rodgers,216,30,186
2022,0,26300,Matt Jones,221,50,171
2022,0,51950,Max McGreevy,221,173,48
2022,0,25198,Francesco Molinari,221,135,86
2022,0,45522,Christiaan Bezuidenhout,222,165,57
2022,0,30692,Scott Stallings,222,54,168
2022,0,32757,Patton Kizzire,223,71,152
2022,0,34256,Andrew Putnam,223,188,35
2022,0,37189,Harold Varner III,224,55,169
2022,0,29974,Branden Grace,225,127,98
2022,0,34363,Tyrrell Hatton,226,56,170
2022,0,30163,Henrik Norlander,226,168,58
2022,0,39953,Chase Seiffert,226,174,52
2022,0,24024,Zach Johnson,228,182,46
2022,0,23108,Matt Kuchar,228,178,50
2022,0,36801,Mark Hubbard,232,177,55
2022,0,35617,Martin Trainer,232,60,172
2022,0,39058,Lucas Herbert,235,47,188
2022,0,35891,Cameron Smith,236,101,135
2022,0,22056,Cameron Percy,237,158,79
2022,0,51634,Sahith Theegala,238,65,173
2022,0,39436,Joshua Creel,239,190,49
2022,0,27974,Sung Kang,239,150,89
2022,0,33597,Harry Higgs,240,83,157
2022,0,33490,Bo Hoag,240,141,99
2022,0,24925,Jonathan Byrd,241,157,84
2022,0,34563,Chesson Hadley,241,83,158
2022,0,53165,Doc Redman,241,144,97
2022,0,24980,Scott Gutschewski,243,123,120
2022,0,40162,Justin Lower,243,147,96
2022,0,27649,Brandt Snedeker,243,182,61
2022,0,54783,Dylan Wu,244,126,118
2022,0,35506,Mackenzie Hughes,245,111,134
2022,0,27895,Jonas Blixt,246,125,121
2022,0,24924,Bill Haas,248,95,153
2022,0,27349,Alex Noren,248,100,148
2022,0,37275,Sam Ryder,254,149,105
2022,0,25493,Nick Taylor,254,129,125
2022,0,29970,Dylan Frittelli,255,66,189
2022,0,23621,Rory Sabbatini,255,172,83
2022,0,33486,Roger Sloan,256,128,128
2022,0,36852,Jim Knous,260,105,155
2022,0,34610,Matthias Schwab,260,151,109
2022,0,27095,Nick Watney,264,90,174
2022,0,51894,Vince Whaley,264,80,184
2022,0,51997,Andrew Novak,266,120,146
2022,0,27139,David Skinns,268,83,185
2022,0,25686,Jason Dufner,271,161,110
2022,0,36884,Ben Kohles,271,180,91
2022,0,29926,Danny Lee,274,114,160
2022,0,25818,Scott Piercy,274,131,143
2022,0,35110,Brett Drewitt,275,130,145
2022,0,34466,Peter Malnati,284,120,164
2022,0,34360,Patrick Reed,284,170,114
2022,0,47128,Richy Werenski,290,141,149
2022,0,36799,Stephan Jaeger,291,155,136
2022,0,29289,S.Y. Noh,295,104,191
2022,0,27770,Camilo Villegas,295,169,126
2022,0,24361,Pat Perez,297,181,116
2022,0,48084,Wesley Bryan,299,117,182
2022,0,23983,Luke Donald,323,184,139
2021,0,46970,Jon Rahm,80,19,61
2021,0,46046,Scottie Scheffler,101,36,65
2021,0,34264,Hudson Swafford,102,45,57
2021,0,39971,Sungjae Im,107,96,11
2021,0,33141,Keegan Bradley,109,61,48
2021,0,21209,Sergio Garcia,109,16,93
2021,0,46717,Viktor Hovland,113,53,60
2021,0,39997,Corey Conners,117,110,7
2021,0,27936,Martin Laird,117,104,13
2021,0,25364,Paul Casey,122,41,81
2021,0,34099,Harris English,122,68,54
2021,0,50525,Collin Morikawa,122,112,10
2021,0,32448,James Hahn,124,96,28
2021,0,30944,Jason Kokrak,127,21,106
2021,0,52372,Cameron Champ,128,3,125
2021,0,40006,Erik van Rooyen,129,33,96
2021,0,31646,Emiliano Grillo,133,83,50
2021,0,45486,Joaquin Niemann,136,13,123
2021,0,32839,Hideki Matsuyama,142,62,80
2021,0,40026,Daniel Berger,143,99,44
2021,0,34363,Tyrrell Hatton,143,73,70
2021,0,30925,Dustin Johnson,143,7,136
2021,0,30163,Henrik Norlander,143,118,25
2021,0,40098,Matt Fitzpatrick,144,127,17
2021,0,27214,Kevin Streelman,145,108,37
2021,0,52375,Doug Ghim,147,132,15
2021,0,28237,Rory McIlroy,147,2,145
2021,0,27554,Scott Harrington,148,30,118
2021,0,40042,Tyler McCumber,148,16,132
2021,0,48081,Xander Schauffele,148,22,126
2021,0,32791,K.H. Lee,149,80,69
2021,0,23320,Ryan Palmer,149,38,111
2021,0,35450,Patrick Cantlay,151,50,101
2021,0,36871,Matthew NeSmith,151,104,47
2021,0,33667,Carlos Ortiz,151,46,105
2021,0,25804,Bubba Watson,151,38,113
2021,0,28089,Jason Day,152,60,92
2021,0,26329,Louis Oosthuizen,153,87,66
2021,0,29518,Brendan Steele,153,69,84
2021,0,47504,Sam Burns,157,33,124
2021,0,24140,Sean O'Hair,157,78,79
2021,0,29420,Billy Horschel,158,116,42
2021,0,29221,Webb Simpson,160,134,26
2021,0,34076,Joel Dahmen,161,139,22
2021,0,48822,Sebastián Muñoz,161,89,72
2021,0,45526,Abraham Ancer,162,157,5
2021,0,27064,Jhonattan Vegas,163,9,154
2021,0,47347,Adam Schenk,165,66,99
2021,0,31557,Jim Herman,166,134,32
2021,0,49298,Kramer Hickok,167,153,14
2021,0,49964,Aaron Wise,167,59,108
2021,0,33413,Ben Martin,168,137,31
2021,0,34255,Joseph Bramlett,169,14,155
2021,0,36689,Brooks Koepka,169,12,157
2021,0,53165,Doc Redman,169,120,49
2021,0,25900,Lucas Glover,170,115,55
2021,0,37189,Harold Varner III,173,58,115
2021,0,37455,Si Woo Kim,175,101,74
2021,0,12716,Charley Hoffman,176,28,148
2021,0,30110,Kyle Stanley,176,142,34
2021,0,27644,Brian Harman,177,147,30
2021,0,27330,Josh Teater,177,159,18
2021,0,47959,Bryson DeChambeau,179,1,178
2021,0,29535,Brice Garnett,179,173,6
2021,0,46402,Talor Gooch,179,72,107
2021,0,33204,Shane Lowry,179,65,114
2021,0,25493,Nick Taylor,179,120,59
2021,0,35658,Kris Ventura,179,37,142
2021,0,56762,Will Gordon,180,5,175
2021,0,27129,Luke List,181,8,173
2021,0,46442,Maverick McNealy,181,77,104
2021,0,37275,Sam Ryder,181,95,86
2021,0,45609,Tyler Duncan,182,159,23
2021,0,39546,Keith Mitchell,182,24,158
2021,0,33404,Chris Baker,183,144,39
2021,0,48045,Michael Gellerman,183,142,41
2021,0,33419,Cameron Tringale,183,89,94
2021,0,26331,Charl Schwartzel,184,46,138
2021,0,45157,Cam Davis,185,19,166
2021,0,49960,Sepp Straka,185,44,141
2021,0,47483,Will Zalatoris,185,23,162
2021,0,39977,Max Homa,186,56,130
2021,0,29268,Bronson Burgoon,187,76,111
2021,0,20229,Stewart Cink,188,27,161
2021,0,29478,Kevin Kisner,188,167,21
2021,0,33122,Russell Knox,188,150,38
2021,0,47993,Denny McCarthy,188,110,78
2021,0,28252,Seamus Power,188,113,75
2021,0,32102,Rickie Fowler,189,98,91
2021,0,34098,Russell Henley,189,162,27
2021,0,32150,Michael Thompson,189,173,16
2021,0,21961,Charles Howell III,190,88,102
2021,0,32757,Patton Kizzire,190,55,135
2021,0,33410,Andrew Landry,190,157,33
2021,0,32816,Satoshi Kodaira,191,182,9
2021,0,20396,Lee Westwood,191,118,73
2021,0,31323,Gary Woodland,191,15,176
2021,0,25818,Scott Piercy,192,83,109
2021,0,26476,Chez Reavie,192,190,2
2021,0,22405,Justin Rose,192,89,103
2021,0,19803,Ryan Armour,193,189,4
2021,0,30911,Tommy Fleetwood,193,56,137
2021,0,35449,Adam Long,193,169,24
2021,0,56278,Matthew Wolff,193,4,189
2021,0,29479,Scott Brown,194,117,77
2021,0,33486,Roger Sloan,194,106,88
2021,0,29725,Tony Finau,195,31,164
2021,0,30927,Brendon Todd,195,194,1
2021,0,39324,J.J. Spaun,196,184,12
2021,0,31560,Brian Stuard,196,193,3
2021,0,48887,Matt Wallace,196,80,116
2021,0,29926,Danny Lee,197,78,119
2021,0,35104,Tom Lewis,197,52,145
2021,0,28420,Ryan Brehm,198,11,187
2021,0,34174,John Huh,198,155,43
2021,0,29908,C.T. Pan,198,101,97
2021,0,39953,Chase Seiffert,198,152,46
2021,0,35310,Lanto Griffin,199,48,151
2021,0,32662,Michael Gligic,200,73,127
2021,0,33399,Adam Hadwin,200,129,71
2021,0,35461,Beau Hossler,200,35,165
2021,0,51766,Wyndham Clark,201,6,195
2021,0,46550,Brandon Hagy,201,10,191
2021,0,32070,Rafael Campos,202,62,140
2021,0,29970,Dylan Frittelli,203,18,185
2021,0,26758,David Hearn,203,195,8
2021,0,24502,Adam Scott,203,29,174
2021,0,25396,Kevin Na,205,170,35
2021,0,36699,Patrick Rodgers,205,26,179
2021,0,35891,Cameron Smith,207,85,122
2021,0,32333,Kevin Tway,207,25,182
2021,0,49766,Hank Lebioda,209,114,95
2021,0,46435,Austin Cook,210,165,45
2021,0,36801,Mark Hubbard,210,191,19
2021,0,26300,Matt Jones,210,40,170
2021,0,33448,Justin Thomas,210,41,169
2021,0,30926,Chris Kirk,211,144,67
2021,0,33490,Bo Hoag,212,154,58
2021,0,23325,Vaughn Taylor,212,192,20
2021,0,49771,J.T. Poston,213,62,151
2021,0,30692,Scott Stallings,213,93,120
2021,0,25686,Jason Dufner,215,163,52
2021,0,23108,Matt Kuchar,216,176,40
2021,0,34360,Patrick Reed,217,149,68
2021,0,27349,Alex Noren,218,85,133
2021,0,34213,Grayson Murray,221,31,190
2021,0,24138,Ian Poulter,221,185,36
2021,0,47128,Richy Werenski,221,122,99
2021,0,33597,Harry Higgs,222,75,147
2021,0,24357,K.J. Choi,224,196,28
2021,0,31420,Anirban Lahiri,224,80,144
2021,0,28775,Nate Lashley,224,137,87
2021,0,24361,Pat Perez,224,141,83
2021,0,35532,Tom Hoge,227,165,62
2021,0,26499,Rafa Cabrera Bello,228,175,53
2021,0,23623,Bo Van Pelt,228,130,98
2021,0,1810,Phil Mickelson,231,54,177
2021,0,32139,Danny Willett,231,122,109
2021,0,33948,Byeong Hun An,235,51,184
2021,0,35617,Martin Trainer,235,43,192
2021,0,27942,Rob Oppenheim,237,186,51
2021,0,27649,Brandt Snedeker,237,181,56
2021,0,22056,Cameron Percy,242,179,63
2021,0,33120,Mark Anderson,243,179,64
2021,0,27141,J.B. Holmes,244,48,196
2021,0,24024,Zach Johnson,244,168,76
2021,0,32640,Troy Merritt,246,161,85
2021,0,34046,Jordan Spieth,246,66,180
2021,0,34563,Chesson Hadley,252,89,163
2021,0,26851,Marc Leishman,253,124,129
2021,0,34314,Sebastian Cappelen,255,69,186
2021,0,27095,Nick Watney,257,69,188
2021,0,24924,Bill Haas,259,106,153
2021,0,23621,Rory Sabbatini,259,177,82
2021,0,51894,Vince Whaley,259,100,159
2021,0,35506,Mackenzie Hughes,261,127,134
2021,0,24781,Hunter Mahan,270,103,167
2021,0,34431,Robert Streb,270,139,131
2021,0,32254,Xinjun Zhang,275,147,128
2021,0,34256,Andrew Putnam,276,187,89
2021,0,28679,Fabián Gómez,278,188,90
2021,0,25632,Jimmy Walker,287,93,194
2021,0,48119,Ben Taylor,291,108,183
2021,0,35230,Nelson Ledesma,293,172,121
2021,0,46441,Robby Shelton,294,126,168
2021,0,23788,D.J. Trahan,294,144,150
2021,0,27770,Camilo Villegas,294,134,160
2021,0,19846,Brian Gay,295,178,117
2021,0,29974,Branden Grace,295,124,171
2021,0,22371,Aaron Baddeley,303,164,139
2021,0,27974,Sung Kang,304,133,171
2021,0,34466,Peter Malnati,311,155,156
2021,0,27556,Ted Potter Jr.,320,171,149
2021,0,39975,Michael Kim,323,130,193
2021,0,23983,Luke Donald,326,183,143
2021,0,32618,Rhein Gibson,331,150,181
2020,1,25364,Paul Casey,75,23,52
2020,-1,46970,Jon Rahm,78,22,56
2020,0,27064,Jhonattan Vegas,90,15,75
2020,0,25900,Lucas Glover,92,55,37
2020,2,27936,Martin Laird,94,45,49
2020,-1,30911,Tommy Fleetwood,96,14,82
2020,-2,46046,Scottie Scheffler,100,16,84
2020,0,39997,Corey Conners,102,82,20
2020,2,53165,Doc Redman,108,95,13
2020,2,39971,Sungjae Im,111,69,42
2020,2,47347,Adam Schenk,117,47,70
2020,-3,40026,Daniel Berger,119,71,48
2020,1,21209,Sergio Garcia,120,27,93
2020,2,29221,Webb Simpson,125,107,18
2020,-5,30925,Dustin Johnson,128,10,118
2020,8,50525,Collin Morikawa,128,97,31
2020,-1,48081,Xander Schauffele,128,30,98
2020,6,23788,D.J. Trahan,128,92,36
2020,3,37189,Harold Varner III,128,49,79
2020,-2,56278,Matthew Wolff,129,9,120
2020,-1,34563,Chesson Hadley,130,108,22
2020,2,46717,Viktor Hovland,131,77,54
2020,1,31323,Gary Woodland,132,30,102
2020,9,34363,Tyrrell Hatton,133,55,78
2020,-1,35658,Kris Ventura,134,28,106
2020,1,33597,Harry Higgs,135,63,72
2020,-10,29420,Billy Horschel,136,77,59
2020,-6,45526,Abraham Ancer,137,94,43
2020,-2,31646,Emiliano Grillo,138,113,25
2020,6,48822,Sebastián Muñoz,138,43,95
2020,-1,32791,K.H. Lee,139,105,34
2020,7,47959,Bryson DeChambeau,141,1,140
2020,1,49960,Sepp Straka,141,41,100
2020,-3,45157,Cam Davis,142,20,122
2020,-5,34099,Harris English,142,65,77
2020,1,29518,Brendan Steele,142,38,104
2020,-3,27330,Josh Teater,142,127,15
2020,-1,30944,Jason Kokrak,145,7,138
2020,-1,25804,Bubba Watson,145,10,135
2020,1,25493,Nick Taylor,147,101,46
2020,-1,30163,Henrik Norlander,149,141,8
2020,0,27554,Scott Harrington,150,24,126
2020,-1,46435,Austin Cook,151,130,21
2020,0,34076,Joel Dahmen,153,115,38
2020,2,35450,Patrick Cantlay,154,40,114
2020,-1,32102,Rickie Fowler,154,119,35
2020,-1,27214,Kevin Streelman,155,129,26
2020,5,52372,Cameron Champ,156,2,154
2020,1,56762,Will Gordon,157,17,140
2020,1,28252,Seamus Power,157,33,124
2020,-2,49298,Kramer Hickok,158,139,19
2020,0,40098,Matt Fitzpatrick,159,121,38
2020,1,52375,Doug Ghim,159,108,51
2020,-5,28237,Rory McIlroy,159,4,155
2020,1,27129,Luke List,160,21,139
2020,0,49964,Aaron Wise,162,59,103
2020,1,33204,Shane Lowry,163,76,87
2020,-4,25818,Scott Piercy,163,100,63
2020,0,36871,Matthew NeSmith,164,117,47
2020,0,26329,Louis Oosthuizen,164,72,92
2020,3,33399,Adam Hadwin,167,127,40
2020,-1,33404,Chris Baker,168,159,9
2020,3,33141,Keegan Bradley,168,63,105
2020,-1,26596,Ryan Moore,168,157,11
2020,1,22405,Justin Rose,171,75,96
2020,2,47504,Sam Burns,173,8,165
2020,1,33490,Bo Hoag,176,121,55
2020,8,34213,Grayson Murray,176,5,171
2020,1,37275,Sam Ryder,176,91,85
2020,1,33122,Russell Knox,177,106,71
2020,2,39546,Keith Mitchell,177,49,128
2020,-11,23320,Ryan Palmer,178,77,101
2020,3,29479,Scott Brown,179,162,17
2020,3,45609,Tyler Duncan,179,173,6
2020,-6,33448,Justin Thomas,179,35,144
2020,2,24502,Adam Scott,180,19,161
2020,4,40042,Tyler McCumber,182,12,170
2020,2,30110,Kyle Stanley,182,177,5
2020,-6,32839,Hideki Matsuyama,183,34,149
2020,5,19803,Ryan Armour,184,182,2
2020,-1,32640,Troy Merritt,184,143,41
2020,-1,34098,Russell Henley,185,155,30
2020,6,31557,Jim Herman,186,176,10
2020,5,35310,Lanto Griffin,187,42,145
2020,2,33410,Andrew Landry,187,158,29
2020,8,26476,Chez Reavie,187,180,7
2020,-3,46441,Robby Shelton,187,101,86
2020,-2,28679,Fabián Gómez,188,160,28
2020,-2,39977,Max Homa,188,67,121
2020,3,51894,Vince Whaley,190,65,125
2020,4,27644,Brian Harman,191,138,53
2020,6,30927,Brendon Todd,191,187,4
2020,5,25349,Tim Wilkinson,192,179,13
2020,9,28420,Ryan Brehm,193,3,190
2020,5,10809,Jim Furyk,193,192,1
2020,2,29535,Brice Garnett,193,148,45
2020,9,46550,Brandon Hagy,193,6,187
2020,-13,29478,Kevin Kisner,193,160,33
2020,5,29926,Danny Lee,193,47,146
2020,5,31560,Brian Stuard,193,190,3
2020,2,21407,Arjun Atwal,195,172,23
2020,-3,32662,Michael Gligic,196,84,112
2020,8,33948,Byeong Hun An,197,28,169
2020,0,29725,Tony Finau,197,13,184
2020,7,36699,Patrick Rodgers,197,18,179
2020,5,32150,Michael Thompson,197,165,32
2020,1,25686,Jason Dufner,198,174,24
2020,-1,26499,Rafa Cabrera Bello,199,133,66
2020,5,27974,Sung Kang,199,39,160
2020,3,26758,David Hearn,200,188,12
2020,5,35461,Beau Hossler,201,26,175
2020,5,36689,Brooks Koepka,201,25,176
2020,2,49771,J.T. Poston,202,153,49
2020,-3,48045,Michael Gellerman,203,136,67
2020,8,45486,Joaquin Niemann,205,53,152
2020,3,23325,Vaughn Taylor,205,189,16
2020,3,27095,Nick Watney,205,43,162
2020,2,24924,Bill Haas,209,126,83
2020,1,47993,Denny McCarthy,210,130,80
2020,2,35449,Adam Long,211,142,69
2020,13,51766,Wyndham Clark,212,32,180
2020,3,46402,Talor Gooch,212,85,127
2020,4,36801,Mark Hubbard,213,155,58
2020,9,23108,Matt Kuchar,213,186,27
2020,1,24361,Pat Perez,213,152,61
2020,1,39953,Chase Seiffert,213,146,67
2020,0,32448,James Hahn,214,133,81
2020,3,26300,Matt Jones,214,97,117
2020,0,35732,Wes Roach,214,149,65
2020,0,31420,Anirban Lahiri,215,125,90
2020,2,49766,Hank Lebioda,217,121,96
2020,5,32366,Kevin Chappell,218,67,151
2020,2,34255,Joseph Bramlett,219,77,142
2020,4,33419,Cameron Tringale,221,49,172
2020,2,47128,Richy Werenski,221,87,134
2020,4,34314,Sebastian Cappelen,223,37,186
2020,1,32139,Danny Willett,224,61,163
2020,3,32333,Kevin Tway,225,36,189
2020,4,21961,Charles Howell III,228,62,166
2020,3,33413,Ben Martin,229,185,44
2020,6,28089,Jason Day,231,74,157
2020,1,46442,Maverick McNealy,231,101,130
2020,11,48887,Matt Wallace,231,53,178
2020,-1,29268,Bronson Burgoon,232,124,108
2020,-1,25396,Kevin Na,232,170,62
2020,3,39324,J.J. Spaun,232,95,137
2020,8,33449,Zack Sucher,232,55,177
2020,4,1810,Phil Mickelson,233,59,174
2020,3,33667,Carlos Ortiz,233,70,163
2020,-1,22056,Cameron Percy,233,117,116
2020,-1,29970,Dylan Frittelli,234,146,88
2020,1,37455,Si Woo Kim,234,87,147
2020,3,24024,Zach Johnson,235,175,60
2020,4,30692,Scott Stallings,235,92,143
2020,8,34046,Jordan Spieth,236,55,181
2020,6,35617,Martin Trainer,236,45,191
2020,6,27942,Rob Oppenheim,238,181,57
2020,3,27649,Brandt Snedeker,238,162,76
2020,-1,27349,Alex Noren,239,108,131
2020,-1,32254,Xinjun Zhang,239,130,109
2020,0,35506,Mackenzie Hughes,240,82,158
2020,4,28775,Nate Lashley,240,167,73
2020,7,35891,Cameron Smith,240,73,167
2020,2,27556,Ted Potter Jr.,244,153,91
2020,6,29484,Peter Uihlein,244,52,192
2020,1,35532,Tom Hoge,245,151,94
2020,1,33120,Mark Anderson,247,137,110
2020,3,48119,Ben Taylor,252,116,136
2020,3,12716,Charley Hoffman,254,104,150
2020,3,40058,Zac Blair,255,191,64
2020,2,29974,Branden Grace,256,97,159
2020,4,25572,Graeme McDowell,257,183,74
2020,2,23623,Bo Van Pelt,259,144,115
2020,14,34360,Patrick Reed,264,108,156
2020,3,34431,Robert Streb,265,133,132
2020,5,40009,Dominic Bozzelli,266,81,185
2020,4,20229,Stewart Cink,266,113,153
2020,5,29908,C.T. Pan,266,167,99
2020,0,34021,Bud Cauley,268,149,119
2020,7,32618,Rhein Gibson,272,90,182
2020,5,23621,Rory Sabbatini,272,183,89
2020,1,28307,Matt Every,273,140,133
2020,4,35230,Nelson Ledesma,273,85,188
2020,-1,33486,Roger Sloan,274,145,129
2020,3,24138,Ian Poulter,278,171,107
2020,4,27963,Chris Stroud,280,167,113
2020,4,25632,Jimmy Walker,282,89,193
2020,3,19846,Brian Gay,285,162,123
2020,5,22371,Aaron Baddeley,288,178,110
2020,6,32757,Patton Kizzire,292,120,172
2020,4,26851,Marc Leishman,295,112,183
2020,7,34466,Peter Malnati,334,166,168
2020,7,34256,Andrew Putnam,340,193,147
2019,0,29518,Brendan Steele,56,34,22
2019,0,31323,Gary Woodland,92,13,79
2019,0,25364,Paul Casey,95,62,33
2019,0,49960,Sepp Straka,96,22,74
2019,0,30946,Alex Prugh,98,27,71
2019,0,47959,Bryson DeChambeau,100,34,66
2019,0,40026,Daniel Berger,103,44,59
2019,0,28237,Rory McIlroy,106,2,104
2019,0,30944,Jason Kokrak,107,17,90
2019,0,39997,Corey Conners,108,66,42
2019,0,33141,Keegan Bradley,111,61,50
2019,0,31646,Emiliano Grillo,112,85,27
2019,0,36689,Brooks Koepka,112,10,102
2019,0,45526,Abraham Ancer,113,103,10
2019,0,46970,Jon Rahm,115,20,95
2019,0,26329,Louis Oosthuizen,118,77,41
2019,0,21961,Charles Howell III,120,32,88
2019,0,29268,Bronson Burgoon,126,79,47
2019,0,46435,Austin Cook,129,120,9
2019,0,34076,Joel Dahmen,130,106,24
2019,0,25900,Lucas Glover,130,79,51
2019,0,30911,Tommy Fleetwood,132,59,73
2019,0,49298,Kramer Hickok,137,120,17
2019,0,27349,Alex Noren,140,43,97
2019,0,49964,Aaron Wise,140,33,107
2019,0,39971,Sungjae Im,141,81,60
2019,0,27936,Martin Laird,141,57,84
2019,0,25818,Scott Piercy,141,106,35
2019,0,33667,Carlos Ortiz,142,44,98
2019,0,27214,Kevin Streelman,142,114,28
2019,0,24781,Hunter Mahan,143,85,58
2019,0,28089,Jason Day,144,38,106
2019,0,32839,Hideki Matsuyama,145,31,114
2019,0,35732,Wes Roach,147,93,54
2019,0,45486,Joaquin Niemann,149,41,108
2019,0,37340,Chase Wright,149,56,93
2019,0,28679,Fabián Gómez,150,125,25
2019,0,33399,Adam Hadwin,151,119,32
2019,0,48081,Xander Schauffele,151,24,127
2019,0,32102,Rickie Fowler,152,30,122
2019,0,49766,Hank Lebioda,152,95,57
2019,0,32640,Troy Merritt,152,103,49
2019,0,39546,Keith Mitchell,153,28,125
2019,0,34099,Harris English,155,44,111
2019,0,34363,Tyrrell Hatton,157,72,85
2019,0,22405,Justin Rose,157,28,129
2019,0,35449,Adam Long,158,112,46
2019,0,27064,Jhonattan Vegas,158,12,146
2019,0,26476,Chez Reavie,159,158,1
2019,0,25804,Bubba Watson,159,6,153
2019,0,25686,Jason Dufner,160,129,31
2019,0,30110,Kyle Stanley,160,141,19
2019,0,29535,Brice Garnett,161,154,7
2019,0,31557,Jim Herman,161,149,12
2019,0,47347,Adam Schenk,162,47,115
2019,0,45157,Cam Davis,164,10,154
2019,0,45609,Tyler Duncan,164,150,14
2019,0,29970,Dylan Frittelli,164,73,91
2019,0,33410,Andrew Landry,165,159,6
2019,0,32150,Michael Thompson,165,147,18
2019,0,27974,Sung Kang,166,48,118
2019,0,34098,Russell Henley,168,152,16
2019,0,47856,Seth Reeves,169,7,162
2019,0,33948,Byeong Hun An,170,15,155
2019,0,33448,Justin Thomas,170,37,133
2019,0,37275,Sam Ryder,171,96,75
2019,0,27644,Brian Harman,172,147,25
2019,0,37189,Harold Varner III,172,38,134
2019,0,23108,Matt Kuchar,173,135,38
2019,0,51766,Wyndham Clark,175,5,170
2019,0,29478,Kevin Kisner,175,160,15
2019,0,52372,Cameron Champ,176,1,175
2019,0,29725,Tony Finau,176,9,167
2019,0,47504,Sam Burns,178,14,164
2019,0,30925,Dustin Johnson,178,4,174
2019,0,47993,Denny McCarthy,178,122,56
2019,0,23621,Rory Sabbatini,178,136,42
2019,0,26596,Ryan Moore,179,177,2
2019,0,23320,Ryan Palmer,180,60,120
2019,0,21528,Henrik Stenson,180,175,5
2019,0,35450,Patrick Cantlay,181,21,160
2019,0,21209,Sergio Garcia,181,34,147
2019,0,34021,Bud Cauley,182,102,80
2019,0,29420,Billy Horschel,182,114,68
2019,0,33418,Shawn Stefani,182,81,101
2019,0,27095,Nick Watney,182,40,142
2019,0,35376,Roberto Díaz,184,154,30
2019,0,28259,Sangmoon Bae,185,73,112
2019,0,27141,J.B. Holmes,185,16,169
2019,0,27129,Luke List,185,3,182
2019,0,49771,J.T. Poston,185,98,87
2019,0,39327,Ben Silverman,185,156,29
2019,0,33486,Roger Sloan,186,84,102
2019,0,30978,Kiradech Aphibarnrat,187,106,81
2019,0,19803,Ryan Armour,188,184,4
2019,0,10809,Jim Furyk,189,186,3
2019,0,35421,Brandon Harkins,189,23,166
2019,0,24502,Adam Scott,189,54,135
2019,0,29221,Webb Simpson,189,145,44
2019,0,46523,Joey Garber,190,96,94
2019,0,27330,Josh Teater,190,112,78
2019,0,25198,Francesco Molinari,191,143,48
2019,0,26300,Matt Jones,192,93,99
2019,0,37455,Si Woo Kim,192,106,86
2019,0,46601,Trey Mullinax,192,8,184
2019,0,47990,Kyle Jones,193,170,23
2019,0,24138,Ian Poulter,193,117,76
2019,0,31560,Brian Stuard,193,185,8
2019,0,40115,Adam Svensson,193,130,63
2019,0,26758,David Hearn,194,181,13
2019,0,33122,Russell Knox,194,139,55
2019,0,48822,Sebastián Muñoz,194,58,136
2019,0,23325,Vaughn Taylor,194,174,20
2019,0,33419,Cameron Tringale,194,70,124
2019,0,28775,Nate Lashley,196,132,64
2019,0,35461,Beau Hossler,197,53,144
2019,0,19846,Brian Gay,198,187,11
2019,0,24024,Zach Johnson,198,153,45
2019,0,34563,Chesson Hadley,200,63,137
2019,0,39324,J.J. Spaun,200,123,77
2019,0,26499,Rafa Cabrera Bello,201,132,69
2019,0,32333,Kevin Tway,201,25,176
2019,0,34306,John Chin,202,50,152
2019,0,34360,Patrick Reed,202,71,131
2019,0,40098,Matt Fitzpatrick,203,151,52
2019,0,40009,Dominic Bozzelli,204,76,128
2019,0,1810,Phil Mickelson,204,19,185
2019,0,25396,Kevin Na,204,132,72
2019,0,46501,Ollie Schniederjans,205,17,188
2019,0,27895,Jonas Blixt,206,136,70
2019,0,29479,Scott Brown,206,145,61
2019,0,32200,Roberto Castro,207,171,36
2019,0,23353,J.J. Henry,207,142,65
2019,0,29926,Danny Lee,207,42,165
2019,0,39977,Max Homa,208,49,159
2019,0,34261,Scott Langley,209,188,21
2019,0,32757,Patton Kizzire,210,91,119
2019,0,32816,Satoshi Kodaira,210,176,34
2019,0,30786,Brady Schnell,210,173,37
2019,0,35617,Martin Trainer,211,25,186
2019,0,26951,Johnson Wagner,212,172,40
2019,0,46402,Talor Gooch,213,65,148
2019,0,36699,Patrick Rodgers,213,52,161
2019,0,30692,Scott Stallings,214,69,145
2019,0,32791,K.H. Lee,216,163,53
2019,0,47128,Richy Werenski,217,101,116
2019,0,26851,Marc Leishman,218,78,140
2019,0,29223,Sam Saunders,219,51,168
2019,0,25493,Nick Taylor,220,111,109
2019,0,20472,Alex Cejka,222,183,39
2019,0,35506,Mackenzie Hughes,222,67,155
2019,0,24361,Pat Perez,226,164,62
2019,0,35532,Tom Hoge,228,123,105
2019,0,25632,Jimmy Walker,228,55,173
2019,0,24924,Bill Haas,230,117,113
2019,0,35891,Cameron Smith,233,92,141
2019,0,27958,Ryan Blaum,234,139,95
2019,0,29908,C.T. Pan,234,167,67
2019,0,49303,Anders Albertson,235,105,130
2019,0,35879,Kelly Kraft,235,125,110
2019,0,32139,Danny Willett,236,98,138
2019,0,12716,Charley Hoffman,237,87,150
2019,0,27649,Brandt Snedeker,237,156,81
2019,0,36799,Stephan Jaeger,239,100,139
2019,0,34264,Hudson Swafford,246,88,158
2019,0,39954,Cody Gribble,247,67,180
2019,0,20572,Rod Pampling,249,160,89
2019,0,36852,Jim Knous,250,73,177
2019,0,32058,José de Jesús Rodríguez,251,125,126
2019,0,29484,Peter Uihlein,251,64,187
2019,0,29974,Branden Grace,252,90,162
2019,0,28252,Seamus Power,252,81,171
2019,0,31420,Anirban Lahiri,257,125,132
2019,0,25572,Graeme McDowell,257,165,92
2019,0,34431,Robert Streb,260,143,117
2019,0,27556,Ted Potter Jr.,263,180,83
2019,0,37454,Whee Kim,269,169,100
2019,0,34046,Jordan Spieth,269,88,181
2019,0,27963,Chris Stroud,279,130,149
2019,0,21731,Freddie Jacobson,288,166,122
2019,0,34466,Peter Malnati,289,110,179
2019,0,30191,Julián Etulain,292,114,178
2019,0,34256,Andrew Putnam,300,179,121
2019,0,37380,Curtis Luck,308,136,172
2019,0,6522,Ernie Els,311,168,143
2019,0,22371,Aaron Baddeley,319,162,157
2019,0,24925,Jonathan Byrd,329,178,151
2019,0,39975,Michael Kim,364,181,183
2018,0,22405,Justin Rose,67,34,33
2018,0,30911,Tommy Fleetwood,72,23,49
2018,0,31323,Gary Woodland,73,7,66
2018,0,33141,Keegan Bradley,80,65,15
2018,0,25198,Francesco Molinari,98,52,46
2018,0,34264,Hudson Swafford,98,41,57
2018,0,29268,Bronson Burgoon,99,41,58
2018,0,32102,Rickie Fowler,101,61,40
2018,0,30110,Kyle Stanley,105,98,7
2018,0,25364,Paul Casey,109,31,78
2018,0,37275,Sam Ryder,109,87,22
2018,0,26329,Louis Oosthuizen,112,61,51
2018,0,49964,Aaron Wise,113,40,73
2018,0,31646,Emiliano Grillo,114,106,8
2018,0,39324,J.J. Spaun,114,82,32
2018,0,39997,Corey Conners,115,36,79
2018,0,47959,Bryson DeChambeau,117,25,92
2018,0,29420,Billy Horschel,117,100,17
2018,0,24502,Adam Scott,117,29,88
2018,0,32254,Xinjun Zhang,117,77,40
2018,0,32366,Kevin Chappell,118,17,101
2018,0,27214,Kevin Streelman,119,107,12
2018,0,29518,Brendan Steele,121,12,109
2018,0,26499,Rafa Cabrera Bello,123,107,16
2018,0,34076,Joel Dahmen,126,97,29
2018,0,25818,Scott Piercy,128,92,36
2018,0,25900,Lucas Glover,129,85,44
2018,0,30925,Dustin Johnson,131,6,125
2018,0,32839,Hideki Matsuyama,132,49,83
2018,0,34098,Russell Henley,134,125,9
2018,0,33948,Byeong Hun An,135,19,116
2018,0,35450,Patrick Cantlay,136,38,98
2018,0,24781,Hunter Mahan,136,90,46
2018,0,45609,Tyler Duncan,137,112,25
2018,0,36699,Patrick Rodgers,137,34,103
2018,0,29908,C.T. Pan,139,126,13
2018,0,21528,Henrik Stenson,140,139,1
2018,0,40026,Daniel Berger,141,85,56
2018,0,21961,Charles Howell III,141,54,87
2018,0,32448,James Hahn,142,77,65
2018,0,29974,Branden Grace,145,74,71
2018,0,39546,Keith Mitchell,145,10,135
2018,0,46970,Jon Rahm,145,16,129
2018,0,24138,Ian Poulter,146,118,28
2018,0,27936,Martin Laird,147,71,76
2018,0,32150,Michael Thompson,147,93,54
2018,0,33448,Justin Thomas,149,11,138
2018,0,37189,Harold Varner III,149,18,131
2018,0,29535,Brice Garnett,150,91,59
2018,0,25804,Bubba Watson,151,9,142
2018,0,30978,Kiradech Aphibarnrat,152,110,42
2018,0,48081,Xander Schauffele,152,28,124
2018,0,46435,Austin Cook,154,130,24
2018,0,27644,Brian Harman,154,133,21
2018,0,28089,Jason Day,155,14,141
2018,0,33122,Russell Knox,155,137,18
2018,0,49771,J.T. Poston,155,55,100
2018,0,26300,Matt Jones,156,30,126
2018,0,32816,Satoshi Kodaira,157,118,39
2018,0,33204,Shane Lowry,157,55,102
2018,0,23320,Ryan Palmer,157,27,130
2018,0,30944,Jason Kokrak,158,15,143
2018,0,29223,Sam Saunders,159,41,118
2018,0,8793,Tiger Woods,159,32,127
2018,0,34046,Jordan Spieth,160,61,99
2018,0,25686,Jason Dufner,162,88,74
2018,0,35545,Blayne Barber,163,110,53
2018,0,36689,Brooks Koepka,163,8,155
2018,0,24140,Sean O'Hair,163,44,119
2018,0,28237,Rory McIlroy,164,1,163
2018,0,45526,Abraham Ancer,165,96,69
2018,0,23353,J.J. Henry,166,135,31
2018,0,27349,Alex Noren,166,69,97
2018,0,35461,Beau Hossler,167,58,109
2018,0,26596,Ryan Moore,167,163,4
2018,0,22056,Cameron Percy,167,99,68
2018,0,25572,Graeme McDowell,171,121,50
2018,0,47347,Adam Schenk,171,26,145
2018,0,34363,Tyrrell Hatton,172,76,96
2018,0,47993,Denny McCarthy,172,100,72
2018,0,27141,J.B. Holmes,174,24,150
2018,0,29478,Kevin Kisner,176,146,30
2018,0,26476,Chez Reavie,176,173,3
2018,0,39328,Conrad Shindler,176,141,35
2018,0,27064,Jhonattan Vegas,176,32,144
2018,0,46601,Trey Mullinax,177,2,175
2018,0,25892,Steve Wheatcroft,177,166,11
2018,0,29725,Tony Finau,178,4,174
2018,0,24358,Robert Garrigus,178,19,159
2018,0,34099,Harris English,179,47,132
2018,0,34563,Chesson Hadley,179,58,121
2018,0,47128,Richy Werenski,179,135,44
2018,0,32640,Troy Merritt,181,100,81
2018,0,27095,Nick Watney,181,21,160
2018,0,50526,Tom Lovelady,183,3,180
2018,0,34213,Grayson Murray,184,22,162
2018,0,47287,Ethan Tracy,186,71,115
2018,0,19803,Ryan Armour,187,185,2
2018,0,27129,Luke List,187,5,182
2018,0,24361,Pat Perez,187,144,43
2018,0,28679,Fabián Gómez,190,142,48
2018,0,29461,Jamie Lovemark,190,37,153
2018,0,39327,Ben Silverman,190,152,38
2018,0,19846,Brian Gay,192,186,6
2018,0,34409,David Lingmerth,194,180,14
2018,0,33399,Adam Hadwin,196,159,37
2018,0,23325,Vaughn Taylor,196,176,20
2018,0,47125,Matt Atkins,197,50,147
2018,0,26851,Marc Leishman,197,80,117
2018,0,31560,Brian Stuard,198,193,5
2018,0,20472,Alex Cejka,199,172,27
2018,0,10809,Jim Furyk,200,190,10
2018,0,35879,Kelly Kraft,201,167,34
2018,0,27556,Ted Potter Jr.,201,178,23
2018,0,36799,Stephan Jaeger,203,69,134
2018,0,32333,Kevin Tway,203,13,190
2018,0,34021,Bud Cauley,206,100,106
2018,0,27649,Brandt Snedeker,206,122,84
2018,0,23541,Ben Crane,207,188,19
2018,0,12716,Charley Hoffman,207,67,140
2018,0,29221,Webb Simpson,207,117,90
2018,0,26758,David Hearn,209,183,26
2018,0,30926,Chris Kirk,209,154,55
2018,0,35310,Lanto Griffin,215,46,169
2018,0,35421,Brandon Harkins,216,38,178
2018,0,28252,Seamus Power,216,45,171
2018,0,24024,Zach Johnson,217,154,63
2018,0,39954,Cody Gribble,219,52,167
2018,0,25396,Kevin Na,219,157,62
2018,0,30692,Scott Stallings,221,64,157
2018,0,46402,Talor Gooch,222,74,148
2018,0,29479,Scott Brown,223,128,95
2018,0,28775,Nate Lashley,223,115,108
2018,0,33418,Shawn Stefani,223,65,158
2018,0,33410,Andrew Landry,224,142,82
2018,0,23621,Rory Sabbatini,224,130,94
2018,0,27958,Ryan Blaum,225,165,60
2018,0,12510,Chad Campbell,225,173,52
2018,0,33413,Ben Martin,227,157,70
2018,0,20229,Stewart Cink,229,83,146
2018,0,35532,Tom Hoge,229,140,89
2018,0,34256,Andrew Putnam,229,116,113
2018,0,35506,Mackenzie Hughes,231,109,122
2018,0,25493,Nick Taylor,231,126,105
2018,0,37278,Nicholas Lindheim,232,120,112
2018,0,35891,Cameron Smith,232,81,151
2018,0,31420,Anirban Lahiri,233,114,119
2018,0,28500,Martin Flores,234,58,176
2018,0,34174,John Huh,234,170,64
2018,0,29926,Danny Lee,234,148,86
2018,0,20572,Rod Pampling,234,168,66
2018,0,27895,Jonas Blixt,236,122,114
2018,0,29484,Peter Uihlein,236,48,188
2018,0,26951,Johnson Wagner,237,176,61
2018,0,26331,Charl Schwartzel,238,67,171
2018,0,29485,Brett Stegmaier,239,100,139
2018,0,46501,Ollie Schniederjans,241,50,191
2018,0,32757,Patton Kizzire,242,77,165
2018,0,24924,Bill Haas,243,94,149
2018,0,23108,Matt Kuchar,244,169,75
2018,0,27963,Chris Stroud,245,154,91
2018,0,1810,Phil Mickelson,246,57,189
2018,0,35376,Roberto Díaz,252,175,77
2018,0,34358,Jonathan Randolph,252,159,93
2018,0,40009,Dominic Bozzelli,253,89,164
2018,0,37455,Si Woo Kim,253,146,107
2018,0,34360,Patrick Reed,256,83,173
2018,0,25632,Jimmy Walker,256,71,185
2018,0,22582,Kyle Thompson,260,181,79
2018,0,20157,Retief Goosen,264,94,170
2018,0,32876,Martin Piller,269,132,137
2018,0,24925,Jonathan Byrd,272,137,135
2018,0,40058,Zac Blair,277,192,85
2018,0,27974,Sung Kang,278,122,156
2018,0,28307,Matt Every,279,113,166
2018,0,37454,Whee Kim,283,179,104
2018,0,31202,William McGirt,284,161,123
2018,0,22371,Aaron Baddeley,291,105,186
2018,0,34466,Peter Malnati,298,144,154
2018,0,25240,D.A. Points,298,189,109
2018,0,28132,Tyrone Van Aswegen,303,151,152
2018,0,34431,Robert Streb,311,128,183
2018,0,37338,Zecheng Dou,312,133,179
2018,0,29222,Billy Hurley III,312,184,128
2018,0,20593,Greg Chalmers,320,187,133
2018,0,39975,Michael Kim,330,153,177
2018,0,35544,Andrew Yun,332,148,184
2018,0,24846,Ricky Barnes,341,148,193
2018,0,27942,Rob Oppenheim,343,182,161
2018,0,31416,Derek Fathauer,350,164,186
2018,0,25834,Daniel Summerhays,351,170,181
2018,0,33419,Cameron Tringale,353,161,192
2018,0,48084,Wesley Bryan,359,191,168
2017,0,33141,Keegan Bradley,69,44,25
2017,0,30110,Kyle Stanley,79,66,13
2017,0,27436,Graham DeLaet,89,34,55
2017,0,25900,Lucas Glover,90,50,40
2017,0,32102,Rickie Fowler,93,41,52
2017,0,46732,Rick Lamb,98,54,44
2017,0,27936,Martin Laird,99,62,37
2017,0,33204,Shane Lowry,100,67,33
2017,0,25198,Francesco Molinari,104,98,6
2017,0,21209,Sergio Garcia,105,30,75
2017,0,25364,Paul Casey,107,58,49
2017,0,31557,Jim Herman,107,96,11
2017,0,29518,Brendan Steele,109,40,69
2017,0,34098,Russell Henley,114,54,60
2017,0,27214,Kevin Streelman,114,84,30
2017,0,34264,Hudson Swafford,116,22,94
2017,0,26289,Boo Weekley,119,116,3
2017,0,31323,Gary Woodland,128,13,115
2017,0,35450,Patrick Cantlay,129,48,81
2017,0,31646,Emiliano Grillo,130,91,39
2017,0,30944,Jason Kokrak,131,17,114
2017,0,25686,Jason Dufner,132,78,54
2017,0,25804,Bubba Watson,132,20,112
2017,0,29223,Sam Saunders,133,88,45
2017,0,48081,Xander Schauffele,134,16,118
2017,0,29478,Kevin Kisner,139,120,19
2017,0,37189,Harold Varner III,139,29,110
2017,0,46970,Jon Rahm,140,20,120
2017,0,29420,Billy Horschel,141,43,98
2017,0,47128,Richy Werenski,141,109,32
2017,0,32366,Kevin Chappell,142,23,119
2017,0,24781,Hunter Mahan,142,79,63
2017,0,30925,Dustin Johnson,145,2,143
2017,0,29725,Tony Finau,146,10,136
2017,0,33122,Russell Knox,146,126,20
2017,0,32839,Hideki Matsuyama,147,26,121
2017,0,26596,Ryan Moore,147,130,17
2017,0,24140,Sean O'Hair,147,58,89
2017,0,24358,Robert Garrigus,148,37,111
2017,0,23621,Rory Sabbatini,148,105,43
2017,0,39324,J.J. Spaun,149,107,42
2017,0,26329,Louis Oosthuizen,152,69,83
2017,0,30191,Julián Etulain,153,89,64
2017,0,32448,James Hahn,153,86,67
2017,0,26476,Chez Reavie,153,149,4
2017,0,23353,J.J. Henry,156,83,73
2017,0,31202,William McGirt,156,149,7
2017,0,33413,Ben Martin,159,103,56
2017,0,23320,Ryan Palmer,159,27,132
2017,0,23497,Tag Ridings,159,32,127
2017,0,24502,Adam Scott,159,15,144
2017,0,22405,Justin Rose,160,35,125
2017,0,36689,Brooks Koepka,161,7,154
2017,0,27129,Luke List,161,4,157
2017,0,29461,Jamie Lovemark,161,24,137
2017,0,40026,Daniel Berger,162,62,100
2017,0,24024,Zach Johnson,162,140,22
2017,0,28237,Rory McIlroy,162,1,161
2017,0,31420,Anirban Lahiri,164,61,103
2017,0,34213,Grayson Murray,164,12,152
2017,0,27064,Jhonattan Vegas,166,33,133
2017,0,34021,Bud Cauley,168,72,96
2017,0,26300,Matt Jones,168,28,140
2017,0,47959,Bryson DeChambeau,169,45,124
2017,0,34409,David Lingmerth,169,113,56
2017,0,12510,Chad Campbell,170,147,23
2017,0,29221,Webb Simpson,170,142,28
2017,0,29485,Brett Stegmaier,170,124,46
2017,0,33448,Justin Thomas,170,8,162
2017,0,12716,Charley Hoffman,171,49,122
2017,0,33399,Adam Hadwin,173,108,65
2017,0,29479,Scott Brown,174,121,53
2017,0,27974,Sung Kang,175,67,108
2017,0,33418,Shawn Stefani,175,84,91
2017,0,23325,Vaughn Taylor,175,161,14
2017,0,46601,Trey Mullinax,176,9,167
2017,0,34046,Jordan Spieth,176,75,101
2017,0,27963,Chris Stroud,176,141,35
2017,0,19803,Ryan Armour,177,176,1
2017,0,33461,Morgan Hoffmann,179,86,93
2017,0,23108,Matt Kuchar,179,148,31
2017,0,26851,Marc Leishman,179,50,129
2017,0,25818,Scott Piercy,179,72,107
2017,0,34358,Jonathan Randolph,179,132,47
2017,0,33948,Byeong Hun An,180,41,139
2017,0,25572,Graeme McDowell,181,173,8
2017,0,29926,Danny Lee,182,111,71
2017,0,29908,C.T. Pan,182,134,48
2017,0,46550,Brandon Hagy,183,3,180
2017,0,25493,Nick Taylor,184,105,79
2017,0,25892,Steve Wheatcroft,184,169,15
2017,0,26499,Rafa Cabrera Bello,185,103,82
2017,0,27644,Brian Harman,186,116,70
2017,0,34174,John Huh,186,136,50
2017,0,29476,Kyle Reifers,187,146,41
2017,0,28420,Ryan Brehm,188,4,184
2017,0,20472,Alex Cejka,188,164,24
2017,0,24361,Pat Perez,188,112,76
2017,0,35545,Blayne Barber,189,109,80
2017,0,28093,Miguel Angel Carballo,189,128,61
2017,0,46440,Smylie Kaufman,189,25,164
2017,0,32333,Kevin Tway,189,10,179
2017,0,35506,Mackenzie Hughes,190,81,109
2017,0,30926,Chris Kirk,190,139,51
2017,0,49771,J.T. Poston,190,77,113
2017,0,28089,Jason Day,191,19,172
2017,0,22056,Cameron Percy,191,96,95
2017,0,27095,Nick Watney,191,35,156
2017,0,24357,K.J. Choi,192,163,29
2017,0,10809,Jim Furyk,192,190,2
2017,0,25834,Daniel Summerhays,192,136,56
2017,0,26758,David Hearn,193,167,26
2017,0,27466,Spencer Levin,193,175,18
2017,0,23541,Ben Crane,194,178,16
2017,0,36699,Patrick Rodgers,194,18,176
2017,0,31560,Brian Stuard,194,189,5
2017,0,26951,Johnson Wagner,194,128,66
2017,0,35300,Andrew Loupe,195,6,189
2017,0,46443,Brian Campbell,196,70,126
2017,0,32200,Roberto Castro,196,169,27
2017,0,40058,Zac Blair,197,188,9
2017,0,22986,Søren Kjeldsen,197,187,10
2017,0,20104,Ken Duke,198,186,12
2017,0,30692,Scott Stallings,198,57,141
2017,0,32640,Troy Merritt,199,114,85
2017,0,35879,Kelly Kraft,200,101,99
2017,0,29720,Andres Gonzales,201,46,155
2017,0,27141,J.B. Holmes,201,14,187
2017,0,20771,Steven Alker,204,183,21
2017,0,24924,Bill Haas,209,92,117
2017,0,25349,Tim Wilkinson,209,173,36
2017,0,34360,Patrick Reed,213,75,138
2017,0,22046,Geoff Ogilvy,214,142,72
2017,0,25240,D.A. Points,214,180,34
2017,0,19846,Brian Gay,215,177,38
2017,0,34099,Harris English,216,30,186
2017,0,28500,Martin Flores,216,39,177
2017,0,34431,Robert Streb,216,81,135
2017,0,27895,Jonas Blixt,218,122,96
2017,0,20572,Rod Pampling,218,131,87
2017,0,26331,Charl Schwartzel,218,47,171
2017,0,25632,Jimmy Walker,219,74,145
2017,0,46501,Ollie Schniederjans,222,37,185
2017,0,29974,Branden Grace,223,100,123
2017,0,20229,Stewart Cink,225,65,160
2017,0,39954,Cody Gribble,225,60,165
2017,0,39975,Michael Kim,225,119,106
2017,0,40009,Dominic Bozzelli,226,80,146
2017,0,28252,Seamus Power,226,53,173
2017,0,29289,S.Y. Noh,227,52,175
2017,0,27649,Brandt Snedeker,227,165,62
2017,0,28679,Fabián Gómez,228,151,77
2017,0,21961,Charles Howell III,228,62,166
2017,0,34466,Peter Malnati,230,162,68
2017,0,32150,Michael Thompson,232,154,78
2017,0,35110,Brett Drewitt,233,145,88
2017,0,20157,Retief Goosen,233,102,131
2017,0,24138,Ian Poulter,233,159,74
2017,0,48822,Sebastián Muñoz,238,70,168
2017,0,28132,Tyrone Van Aswegen,239,134,105
2017,0,24507,Jason Bohn,241,185,56
2017,0,27958,Ryan Blaum,242,156,86
2017,0,25396,Kevin Na,242,158,84
2017,0,35891,Cameron Smith,243,94,149
2017,0,28307,Matt Every,244,56,188
2017,0,1810,Phil Mickelson,251,89,162
2017,0,36801,Mark Hubbard,252,160,92
2017,0,33120,Mark Anderson,259,157,102
2017,0,37455,Si Woo Kim,260,118,142
2017,0,32757,Patton Kizzire,270,92,178
2017,0,25191,Gonzalo Fernandez-Castaño,273,99,174
2017,0,29222,Billy Hurley III,273,183,90
2017,0,37454,Whee Kim,274,115,159
2017,0,22371,Aaron Baddeley,275,94,181
2017,0,29740,Brad Fritsch,275,127,148
2017,0,25720,Chad Collins,281,166,115
2017,0,20593,Greg Chalmers,285,181,104
2017,0,37278,Nicholas Lindheim,287,136,151
2017,0,27770,Camilo Villegas,293,124,169
2017,0,33419,Cameron Tringale,296,168,128
2017,0,31416,Derek Fathauer,300,142,158
2017,0,48084,Wesley Bryan,302,172,130
2017,0,35532,Tom Hoge,304,151,153
2017,0,6522,Ernie Els,305,155,150
2017,0,30852,Ryo Ishikawa,305,122,183
2017,0,23800,Bryce Molder,316,182,134
2017,0,24846,Ricky Barnes,323,153,170
2017,0,25274,Steven Bowditch,323,133,190
2017,0,23983,Luke Donald,325,178,147
2017,0,25345,Carl Pettersson,353,171,182
2016,0,33141,Keegan Bradley,64,27,37
2016,0,25900,Lucas Glover,75,35,40
2016,0,34264,Hudson Swafford,81,7,74
2016,0,31646,Emiliano Grillo,84,67,17
2016,0,33410,Andrew Landry,85,59,26
2016,0,28237,Rory McIlroy,86,9,77
2016,0,25364,Paul Casey,90,54,36
2016,0,24461,Thomas Aiken,91,89,2
2016,0,21209,Sergio Garcia,98,28,70
2016,0,35451,Scott Pinckney,99,43,56
2016,0,26289,Boo Weekley,100,84,16
2016,0,33204,Shane Lowry,101,32,69
2016,0,34098,Russell Henley,103,48,55
2016,0,31557,Jim Herman,112,87,25
2016,0,29518,Brendan Steele,114,20,94
2016,0,29479,Scott Brown,123,76,47
2016,0,30944,Jason Kokrak,125,6,119
2016,0,37455,Si Woo Kim,126,69,57
2016,0,37189,Harold Varner III,126,22,104
2016,0,25686,Jason Dufner,128,70,58
2016,0,27436,Graham DeLaet,132,37,95
2016,0,32839,Hideki Matsuyama,132,65,67
2016,0,24140,Sean O'Hair,132,20,112
2016,0,29485,Brett Stegmaier,132,52,80
2016,0,32366,Kevin Chappell,133,46,87
2016,0,26476,Chez Reavie,133,123,10
2016,0,32102,Rickie Fowler,136,23,113
2016,0,36689,Brooks Koepka,136,19,117
2016,0,35732,Wes Roach,137,59,78
2016,0,29478,Kevin Kisner,138,105,33
2016,0,25818,Scott Piercy,138,37,101
2016,0,26329,Louis Oosthuizen,139,68,71
2016,0,30925,Dustin Johnson,140,2,138
2016,0,23320,Ryan Palmer,140,12,128
2016,0,33399,Adam Hadwin,141,92,49
2016,0,22405,Justin Rose,143,16,127
2016,0,27214,Kevin Streelman,144,104,40
2016,0,33122,Russell Knox,145,137,8
2016,0,26851,Marc Leishman,145,55,90
2016,0,27644,Brian Harman,146,95,51
2016,0,29461,Jamie Lovemark,146,11,135
2016,0,20691,Greg Owen,146,39,107
2016,0,31202,William McGirt,149,118,31
2016,0,30110,Kyle Stanley,150,112,38
2016,0,22892,Jason Gore,151,103,48
2016,0,29476,Kyle Reifers,153,123,30
2016,0,34174,John Huh,154,145,9
2016,0,31323,Gary Woodland,154,10,144
2016,0,12510,Chad Campbell,155,116,39
2016,0,32200,Roberto Castro,155,149,6
2016,0,22046,Geoff Ogilvy,155,80,75
2016,0,29420,Billy Horschel,156,72,84
2016,0,35545,Blayne Barber,157,97,60
2016,0,36699,Patrick Rodgers,157,26,131
2016,0,37273,Derek Ernst,159,63,96
2016,0,24924,Bill Haas,159,97,62
2016,0,34409,David Lingmerth,159,144,15
2016,0,23108,Matt Kuchar,161,137,24
2016,0,20229,Stewart Cink,162,42,120
2016,0,20572,Rod Pampling,162,117,45
2016,0,27064,Jhonattan Vegas,162,14,148
2016,0,30163,Henrik Norlander,164,112,52
2016,0,25804,Bubba Watson,164,4,160
2016,0,24502,Adam Scott,166,13,153
2016,0,10809,Jim Furyk,167,160,7
2016,0,37454,Whee Kim,168,118,50
2016,0,26596,Ryan Moore,168,150,18
2016,0,27466,Spencer Levin,169,157,12
2016,0,25572,Graeme McDowell,169,156,13
2016,0,32448,James Hahn,172,88,84
2016,0,34261,Scott Langley,174,139,35
2016,0,29926,Danny Lee,174,130,44
2016,0,33413,Ben Martin,174,108,66
2016,0,34046,Jordan Spieth,174,51,123
2016,0,32150,Michael Thompson,174,85,89
2016,0,25198,Francesco Molinari,175,129,46
2016,0,34265,Will Wilcox,176,73,103
2016,0,20472,Alex Cejka,177,155,22
2016,0,8075,Jerry Kelly,177,174,3
2016,0,26951,Johnson Wagner,177,101,76
2016,0,29725,Tony Finau,178,3,175
2016,0,28679,Fabián Gómez,178,105,73
2016,0,26758,David Hearn,179,158,21
2016,0,27974,Sung Kang,179,77,102
2016,0,29223,Sam Saunders,179,81,98
2016,0,40026,Daniel Berger,180,34,146
2016,0,27141,J.B. Holmes,180,1,179
2016,0,31560,Brian Stuard,180,176,4
2016,0,23621,Rory Sabbatini,182,118,64
2016,0,25493,Nick Taylor,184,47,137
2016,0,40058,Zac Blair,185,180,5
2016,0,20766,Padraig Harrington,185,97,88
2016,0,30711,Colt Knost,185,184,1
2016,0,35879,Kelly Kraft,185,93,92
2016,0,24358,Robert Garrigus,186,18,168
2016,0,26331,Charl Schwartzel,186,44,142
2016,0,20848,Ángel Cabrera,187,63,124
2016,0,27129,Luke List,187,7,180
2016,0,26300,Matt Jones,188,56,132
2016,0,27649,Brandt Snedeker,188,75,113
2016,0,35300,Andrew Loupe,189,5,184
2016,0,30692,Scott Stallings,190,50,140
2016,0,34099,Harris English,191,29,162
2016,0,21961,Charles Howell III,191,17,174
2016,0,27936,Martin Laird,191,33,158
2016,0,33448,Justin Thomas,191,24,167
2016,0,34563,Chesson Hadley,192,45,147
2016,0,34360,Patrick Reed,192,41,151
2016,0,20645,John Senden,192,95,97
2016,0,34431,Robert Streb,192,59,133
2016,0,24507,Jason Bohn,193,179,14
2016,0,33461,Morgan Hoffmann,195,66,129
2016,0,24781,Hunter Mahan,195,56,139
2016,0,2206,David Toms,195,184,11
2016,0,28089,Jason Day,196,15,181
2016,0,10213,Dicky Pride,196,173,23
2016,0,28158,Steve Marino,197,79,118
2016,0,29221,Webb Simpson,197,132,65
2016,0,36801,Mark Hubbard,198,164,34
2016,0,33418,Shawn Stefani,198,78,120
2016,0,24024,Zach Johnson,199,167,32
2016,0,25396,Kevin Na,199,170,29
2016,0,23325,Vaughn Taylor,199,127,72
2016,0,24357,K.J. Choi,200,180,20
2016,0,12716,Charley Hoffman,200,36,164
2016,0,46440,Smylie Kaufman,201,30,171
2016,0,21878,Mark Wilson,201,182,19
2016,0,29222,Billy Hurley III,204,176,28
2016,0,30926,Chris Kirk,204,136,68
2016,0,33667,Carlos Ortiz,204,31,173
2016,0,45526,Abraham Ancer,205,178,27
2016,0,29974,Branden Grace,206,48,158
2016,0,29268,Bronson Burgoon,207,71,136
2016,0,20104,Ken Duke,207,164,43
2016,0,32640,Troy Merritt,207,126,81
2016,0,25632,Jimmy Walker,207,24,183
2016,0,20098,Stuart Appleby,215,152,63
2016,0,23541,Ben Crane,216,162,54
2016,0,32618,Rhein Gibson,216,40,176
2016,0,27963,Chris Stroud,218,132,86
2016,0,1810,Phil Mickelson,219,56,163
2016,0,27895,Jonas Blixt,220,90,130
2016,0,24912,Will MacKenzie,223,140,83
2016,0,23800,Bryce Molder,223,164,59
2016,0,29720,Andres Gonzales,224,59,165
2016,0,34262,Jon Curran,225,183,42
2016,0,24490,George McNeill,225,147,78
2016,0,23353,J.J. Henry,227,123,104
2016,0,6527,Steve Stricker,228,175,53
2016,0,25892,Steve Wheatcroft,228,135,93
2016,0,25834,Daniel Summerhays,229,114,115
2016,0,27747,Hiroshi Iwata,230,108,122
2016,0,23638,Brendon de Jonge,231,122,109
2016,0,31420,Anirban Lahiri,232,82,150
2016,0,28114,Dawie van der Walt,232,91,141
2016,0,25349,Tim Wilkinson,232,171,61
2016,0,29289,S.Y. Noh,234,52,182
2016,0,6567,Vijay Singh,236,93,143
2016,0,22371,Aaron Baddeley,237,82,155
2016,0,35891,Cameron Smith,240,132,108
2016,0,32876,Martin Piller,241,130,111
2016,0,33419,Cameron Tringale,241,142,99
2016,0,32757,Patton Kizzire,243,86,157
2016,0,28092,D.H. Lee,243,161,82
2016,0,6522,Ernie Els,244,74,170
2016,0,28475,Jeff Overton,249,143,106
2016,0,35532,Tom Hoge,252,100,152
2016,0,25240,D.A. Points,253,153,100
2016,0,35539,Luke Guthrie,256,102,154
2016,0,20157,Retief Goosen,257,108,149
2016,0,34466,Peter Malnati,260,169,91
2016,0,39975,Michael Kim,264,148,116
2016,0,29745,Tyler Aldridge,267,141,126
2016,0,21731,Freddie Jacobson,272,162,110
2016,0,24846,Ricky Barnes,284,118,166
2016,0,28132,Tyrone Van Aswegen,285,114,171
2016,0,31416,Derek Fathauer,289,111,178
2016,0,25274,Steven Bowditch,292,107,185
2016,0,30927,Brendon Todd,292,167,125
2016,0,23983,Luke Donald,295,151,144
2016,0,27770,Camilo Villegas,304,127,177
2016,0,25720,Chad Collins,305,171,134
2016,0,24494,Erik Compton,314,145,169
2016,0,27942,Rob Oppenheim,314,158,156
2016,0,10885,Robert Allenby,315,154,161
2015,0,21528,Henrik Stenson,55,43,12
2015,0,34265,Will Wilcox,60,42,18
2015,0,33141,Keegan Bradley,62,10,52
2015,0,22405,Justin Rose,78,14,64
2015,0,27436,Graham DeLaet,79,32,47
2015,0,32334,Charlie Beljan,89,6,83
2015,0,34098,Russell Henley,90,36,54
2015,0,25364,Paul Casey,93,35,58
2015,0,31557,Jim Herman,95,62,33
2015,0,34264,Hudson Swafford,103,29,74
2015,0,25900,Lucas Glover,104,38,66
2015,0,37273,Derek Ernst,106,50,56
2015,0,32839,Hideki Matsuyama,106,57,49
2015,0,1706,Davis Love III,107,56,51
2015,0,24502,Adam Scott,111,4,107
2015,0,29518,Brendan Steele,113,16,97
2015,0,27214,Kevin Streelman,113,93,20
2015,0,40026,Daniel Berger,122,18,104
2015,0,29420,Billy Horschel,122,53,69
2015,0,22892,Jason Gore,123,87,36
2015,0,29221,Webb Simpson,123,97,26
2015,0,32102,Rickie Fowler,126,39,87
2015,0,20645,John Senden,126,89,37
2015,0,26331,Charl Schwartzel,127,24,103
2015,0,26476,Chez Reavie,128,125,3
2015,0,29223,Sam Saunders,130,68,62
2015,0,32366,Kevin Chappell,132,67,65
2015,0,33418,Shawn Stefani,132,44,88
2015,0,30946,Alex Prugh,138,49,89
2015,0,34409,David Lingmerth,139,93,46
2015,0,35541,John Peterson,140,110,30
2015,0,20396,Lee Westwood,144,25,119
2015,0,28780,Nicholas Thompson,146,127,19
2015,0,25686,Jason Dufner,148,121,27
2015,0,21209,Sergio Garcia,148,25,123
2015,0,29478,Kevin Kisner,148,114,34
2015,0,26329,Louis Oosthuizen,148,31,117
2015,0,33667,Carlos Ortiz,150,33,117
2015,0,24140,Sean O'Hair,151,47,104
2015,0,26289,Boo Weekley,151,76,75
2015,0,33448,Justin Thomas,152,15,137
2015,0,36689,Brooks Koepka,153,8,145
2015,0,25198,Francesco Molinari,154,153,1
2015,0,24924,Bill Haas,155,82,73
2015,0,27466,Spencer Levin,155,139,16
2015,0,27933,John Merrick,155,133,22
2015,0,36699,Patrick Rodgers,155,9,146
2015,0,25804,Bubba Watson,155,2,153
2015,0,33399,Adam Hadwin,156,108,48
2015,0,24024,Zach Johnson,156,148,8
2015,0,27936,Martin Laird,157,22,135
2015,0,34046,Jordan Spieth,158,78,80
2015,0,26596,Ryan Moore,159,148,11
2015,0,34431,Robert Streb,159,36,123
2015,0,27095,Nick Watney,159,61,98
2015,0,33413,Ben Martin,160,110,50
2015,0,24925,Jonathan Byrd,162,117,45
2015,0,33122,Russell Knox,164,136,28
2015,0,23320,Ryan Palmer,164,13,151
2015,0,28089,Jason Day,165,3,162
2015,0,26300,Matt Jones,165,46,119
2015,0,32448,James Hahn,166,50,116
2015,0,30925,Dustin Johnson,166,1,165
2015,0,30944,Jason Kokrak,166,11,155
2015,0,25369,Jamie Donaldson,167,54,113
2015,0,10809,Jim Furyk,168,151,17
2015,0,27644,Brian Harman,168,113,55
2015,0,26951,Johnson Wagner,168,82,86
2015,0,34099,Harris English,169,33,136
2015,0,25818,Scott Piercy,169,41,128
2015,0,24358,Robert Garrigus,170,20,150
2015,0,12716,Charley Hoffman,170,29,141
2015,0,31323,Gary Woodland,170,12,158
2015,0,12510,Chad Campbell,172,131,41
2015,0,20771,Steven Alker,173,167,6
2015,0,35545,Blayne Barber,173,103,70
2015,0,33419,Cameron Tringale,173,152,21
2015,0,23638,Brendon de Jonge,174,130,44
2015,0,34174,John Huh,174,160,14
2015,0,24507,Jason Bohn,176,171,5
2015,0,24361,Pat Perez,178,135,43
2015,0,29725,Tony Finau,179,7,172
2015,0,8075,Jerry Kelly,179,170,9
2015,0,27141,J.B. Holmes,180,5,175
2015,0,30711,Colt Knost,180,173,7
2015,0,23108,Matt Kuchar,180,104,76
2015,0,24781,Hunter Mahan,181,50,131
2015,0,34130,Sung Joon Park,181,139,42
2015,0,23353,J.J. Henry,183,72,111
2015,0,31202,William McGirt,183,158,25
2015,0,1810,Phil Mickelson,183,22,161
2015,0,20691,Greg Owen,183,62,121
2015,0,30736,Oscar Fraustro,186,93,93
2015,0,10860,Justin Leonard,186,182,4
2015,0,23548,Bill Lunde,186,115,71
2015,0,24490,George McNeill,186,126,60
2015,0,22046,Geoff Ogilvy,186,64,122
2015,0,30927,Brendon Todd,186,176,10
2015,0,2206,David Toms,186,184,2
2015,0,25892,Steve Wheatcroft,186,107,79
2015,0,28500,Martin Flores,187,39,148
2015,0,27064,Jhonattan Vegas,187,27,160
2015,0,35451,Scott Pinckney,189,88,101
2015,0,31560,Brian Stuard,189,174,15
2015,0,29479,Scott Brown,190,108,82
2015,0,33486,Roger Sloan,190,65,125
2015,0,22293,Heath Slocum,190,177,13
2015,0,20848,Ángel Cabrera,191,28,163
2015,0,20104,Ken Duke,191,168,23
2015,0,24138,Ian Poulter,193,121,72
2015,0,25274,Steven Bowditch,194,18,176
2015,0,21961,Charles Howell III,196,17,179
2015,0,28486,Michael Putnam,196,101,95
2015,0,29720,Andres Gonzales,197,57,140
2015,0,25191,Gonzalo Fernandez-Castaño,198,98,100
2015,0,22056,Cameron Percy,199,90,109
2015,0,6567,Vijay Singh,199,85,114
2015,0,23623,Bo Van Pelt,199,93,106
2015,0,32200,Roberto Castro,200,160,40
2015,0,23621,Rory Sabbatini,200,90,110
2015,0,25632,Jimmy Walker,201,21,180
2015,0,40058,Zac Blair,203,180,23
2015,0,36801,Mark Hubbard,203,165,38
2015,0,27963,Chris Stroud,203,146,57
2015,0,23800,Bryce Molder,204,169,35
2015,0,27649,Brandt Snedeker,204,105,99
2015,0,29476,Kyle Reifers,206,112,94
2015,0,28259,Sangmoon Bae,207,92,115
2015,0,21753,Brian Davis,207,178,29
2015,0,35532,Tom Hoge,208,74,134
2015,0,29926,Danny Lee,208,145,63
2015,0,20472,Alex Cejka,209,141,68
2015,0,20229,Stewart Cink,209,65,144
2015,0,34262,Jon Curran,211,179,32
2015,0,25345,Carl Pettersson,211,81,130
2015,0,32640,Troy Merritt,212,131,81
2015,0,39977,Max Homa,213,59,154
2015,0,23541,Ben Crane,214,183,31
2015,0,26758,David Hearn,214,156,58
2015,0,29535,Brice Garnett,215,119,96
2015,0,33461,Morgan Hoffmann,215,45,170
2015,0,21878,Mark Wilson,215,162,53
2015,0,28023,Byron Smith,216,77,139
2015,0,30926,Chris Kirk,218,128,90
2015,0,29222,Billy Hurley III,220,181,39
2015,0,30692,Scott Stallings,220,78,142
2015,0,20157,Retief Goosen,222,71,151
2015,0,26851,Marc Leishman,222,55,167
2015,0,10885,Robert Allenby,225,147,78
2015,0,25562,Andres Romero,225,47,178
2015,0,27895,Jonas Blixt,228,116,112
2015,0,6522,Ernie Els,229,80,149
2015,0,34563,Chesson Hadley,229,82,147
2015,0,25834,Daniel Summerhays,229,137,92
2015,0,25493,Nick Taylor,231,72,159
2015,0,25720,Chad Collins,232,166,66
2015,0,24494,Erik Compton,232,105,127
2015,0,24357,K.J. Choi,235,174,61
2015,0,32150,Michael Thompson,235,98,137
2015,0,20593,Greg Chalmers,239,154,85
2015,0,29289,S.Y. Noh,239,70,169
2015,0,34360,Patrick Reed,240,69,171
2015,0,25349,Tim Wilkinson,240,163,77
2015,0,25396,Kevin Na,243,159,84
2015,0,22371,Aaron Baddeley,244,60,184
2015,0,29425,Andrew Svoboda,245,119,126
2015,0,28679,Fabián Gómez,246,144,102
2015,0,27770,Camilo Villegas,247,74,173
2015,0,34261,Scott Langley,248,157,91
2015,0,30852,Ryo Ishikawa,256,100,156
2015,0,37454,Whee Kim,258,150,108
2015,0,28475,Jeff Overton,266,134,132
2015,0,20766,Padraig Harrington,267,86,181
2015,0,35539,Luke Guthrie,271,138,133
2015,0,31416,Derek Fathauer,283,101,182
2015,0,34358,Jonathan Randolph,284,118,166
2015,0,31193,Jim Renner,284,141,143
2015,0,23048,Eric Axley,288,124,164
2015,0,23983,Luke Donald,301,172,129
2015,0,28307,Matt Every,306,123,183
2015,0,28132,Tyrone Van Aswegen,306,129,177
2015,0,25240,D.A. Points,312,155,157
2015,0,24846,Ricky Barnes,315,141,174
2015,0,34256,Andrew Putnam,332,164,168
2014,0,25900,Lucas Glover,74,20,54
2014,0,21528,Henrik Stenson,78,64,14
2014,0,24781,Hunter Mahan,81,45,36
2014,0,34264,Hudson Swafford,82,33,49
2014,0,37273,Derek Ernst,83,38,45
2014,0,32366,Kevin Chappell,84,43,41
2014,0,33418,Shawn Stefani,84,31,53
2014,0,33141,Keegan Bradley,86,17,69
2014,0,27436,Graham DeLaet,89,14,75
2014,0,24502,Adam Scott,93,13,80
2014,0,29420,Billy Horschel,99,76,23
2014,0,27064,Jhonattan Vegas,101,8,93
2014,0,27095,Nick Watney,101,45,56
2014,0,25804,Bubba Watson,103,1,102
2014,0,26289,Boo Weekley,110,100,10
2014,0,28237,Rory McIlroy,111,3,108
2014,0,27214,Kevin Streelman,113,97,16
2014,0,26329,Louis Oosthuizen,119,21,98
2014,0,34265,Will Wilcox,121,36,85
2014,0,33413,Ben Martin,122,75,47
2014,0,30110,Kyle Stanley,122,33,89
2014,0,23638,Brendon de Jonge,123,106,17
2014,0,34098,Russell Henley,123,61,62
2014,0,26679,Kevin Stadler,125,76,49
2014,0,31557,Jim Herman,126,52,74
2014,0,27936,Martin Laird,126,37,89
2014,0,23353,J.J. Henry,128,82,46
2014,0,25444,Justin Hicks,128,125,3
2014,0,24912,Will MacKenzie,128,84,44
2014,0,31323,Gary Woodland,128,9,119
2014,0,21209,Sergio Garcia,130,57,73
2014,0,32839,Hideki Matsuyama,130,51,79
2014,0,34099,Harris English,132,26,106
2014,0,32334,Charlie Beljan,136,11,125
2014,0,28780,Nicholas Thompson,136,114,22
2014,0,24924,Bill Haas,137,73,64
2014,0,27933,John Merrick,137,122,15
2014,0,29479,Scott Brown,138,112,26
2014,0,27408,Martin Kaymer,138,50,88
2014,0,33122,Russell Knox,138,120,18
2014,0,26596,Ryan Moore,138,129,9
2014,0,32102,Rickie Fowler,141,33,108
2014,0,34431,Robert Streb,141,25,116
2014,0,12510,Chad Campbell,142,107,35
2014,0,29425,Andrew Svoboda,142,111,31
2014,0,23623,Bo Van Pelt,143,78,65
2014,0,27330,Josh Teater,144,53,91
2014,0,29518,Brendan Steele,145,28,117
2014,0,30926,Chris Kirk,146,80,66
2014,0,20645,John Senden,146,95,51
2014,0,24024,Zach Johnson,147,141,6
2014,0,30925,Dustin Johnson,148,2,146
2014,0,28089,Jason Day,149,18,131
2014,0,20848,Ángel Cabrera,151,12,139
2014,0,26331,Charl Schwartzel,151,30,121
2014,0,24358,Robert Garrigus,153,7,146
2014,0,36689,Brooks Koepka,156,6,150
2014,0,23108,Matt Kuchar,156,136,20
2014,0,23320,Ryan Palmer,156,23,133
2014,0,35541,John Peterson,157,102,55
2014,0,12716,Charley Hoffman,158,26,132
2014,0,10809,Jim Furyk,159,155,4
2014,0,34174,John Huh,159,134,25
2014,0,28486,Michael Putnam,159,65,94
2014,0,29740,Brad Fritsch,160,56,104
2014,0,22405,Justin Rose,160,49,111
2014,0,35732,Wes Roach,161,65,96
2014,0,20396,Lee Westwood,162,71,91
2014,0,32150,Michael Thompson,164,93,71
2014,0,1706,Davis Love III,165,41,124
2014,0,25364,Paul Casey,166,65,101
2014,0,27141,J.B. Holmes,168,4,164
2014,0,29221,Webb Simpson,168,98,70
2014,0,31560,Brian Stuard,168,137,31
2014,0,29926,Danny Lee,169,132,37
2014,0,30944,Jason Kokrak,171,14,157
2014,0,22293,Heath Slocum,171,166,5
2014,0,25834,Daniel Summerhays,171,141,30
2014,0,26851,Marc Leishman,173,32,141
2014,0,27556,Ted Potter Jr.,173,162,11
2014,0,2206,David Toms,174,173,1
2014,0,27770,Camilo Villegas,174,68,106
2014,0,26758,David Hearn,175,156,19
2014,0,29222,Billy Hurley III,175,168,7
2014,0,23135,Tim Clark,176,174,2
2014,0,25345,Carl Pettersson,176,47,129
2014,0,27963,Chris Stroud,176,119,57
2014,0,26300,Matt Jones,177,41,136
2014,0,25572,Graeme McDowell,177,165,12
2014,0,21878,Mark Wilson,177,153,24
2014,0,24663,Y.E. Yang,177,143,34
2014,0,30692,Scott Stallings,178,23,155
2014,0,20104,Ken Duke,179,171,8
2014,0,24925,Jonathan Byrd,180,102,78
2014,0,25686,Jason Dufner,181,122,59
2014,0,21961,Charles Howell III,181,9,172
2014,0,35300,Andrew Loupe,181,4,177
2014,0,27649,Brandt Snedeker,181,121,60
2014,0,20229,Stewart Cink,182,61,121
2014,0,29461,Jamie Lovemark,182,16,166
2014,0,1724,Jeff Maggert,182,169,13
2014,0,32333,Kevin Tway,182,55,127
2014,0,28259,Sangmoon Bae,184,98,86
2014,0,21753,Brian Davis,184,163,21
2014,0,23541,Ben Crane,186,157,29
2014,0,24490,George McNeill,188,117,71
2014,0,24140,Sean O'Hair,188,21,167
2014,0,25274,Steven Bowditch,189,29,160
2014,0,24138,Ian Poulter,189,102,87
2014,0,6567,Vijay Singh,189,89,100
2014,0,24507,Jason Bohn,190,151,39
2014,0,32448,James Hahn,190,91,99
2014,0,29478,Kevin Kisner,190,107,83
2014,0,27466,Spencer Levin,190,150,40
2014,0,30927,Brendon Todd,190,148,42
2014,0,27644,Brian Harman,191,94,97
2014,0,31202,William McGirt,193,160,33
2014,0,8075,Jerry Kelly,194,167,27
2014,0,25632,Jimmy Walker,195,19,176
2014,0,28500,Martin Flores,196,44,152
2014,0,25396,Kevin Na,196,148,48
2014,0,32200,Roberto Castro,197,134,63
2014,0,22621,Ben Curtis,197,154,43
2014,0,33419,Cameron Tringale,197,139,58
2014,0,28092,D.H. Lee,198,170,28
2014,0,25240,D.A. Points,198,131,67
2014,0,22913,John Rollins,199,86,113
2014,0,34409,David Lingmerth,200,88,112
2014,0,30750,Tommy Gainey,201,59,142
2014,0,29289,S.Y. Noh,201,40,161
2014,0,35139,Richard Lee,202,125,77
2014,0,22046,Geoff Ogilvy,202,68,134
2014,0,20498,Briny Baird,204,144,60
2014,0,24357,K.J. Choi,204,152,52
2014,0,34021,Bud Cauley,207,63,144
2014,0,32640,Troy Merritt,207,124,83
2014,0,10885,Robert Allenby,208,127,81
2014,0,25191,Gonzalo Fernandez-Castaño,210,102,108
2014,0,22378,Trevor Immelman,210,74,136
2014,0,27120,Troy Matteson,210,39,171
2014,0,1810,Phil Mickelson,210,70,140
2014,0,33461,Morgan Hoffmann,213,48,165
2014,0,10860,Justin Leonard,215,177,38
2014,0,25562,Andres Romero,216,53,163
2014,0,23621,Rory Sabbatini,217,58,159
2014,0,34046,Jordan Spieth,218,89,129
2014,0,29535,Brice Garnett,220,92,128
2014,0,24361,Pat Perez,220,115,105
2014,0,34360,Patrick Reed,229,71,158
2014,0,23983,Luke Donald,231,164,67
2014,0,34563,Chesson Hadley,232,84,148
2014,0,22371,Aaron Baddeley,235,60,175
2014,0,35539,Luke Guthrie,235,109,126
2014,0,34261,Scott Langley,239,145,94
2014,0,26956,Bronson La'Cassie,241,127,114
2014,0,7867,Woody Austin,242,160,82
2014,0,24846,Ricky Barnes,244,82,162
2014,0,6522,Ernie Els,248,79,169
2014,0,30852,Ryo Ishikawa,249,80,169
2014,0,19846,Brian Gay,251,175,76
2014,0,20157,Retief Goosen,252,96,156
2014,0,21731,Freddie Jacobson,253,130,123
2014,0,31193,Jim Renner,254,101,153
2014,0,28475,Jeff Overton,255,110,145
2014,0,28132,Tyrone Van Aswegen,255,87,168
2014,0,25349,Tim Wilkinson,257,140,117
2014,0,20098,Stuart Appleby,262,159,103
2014,0,26951,Johnson Wagner,262,113,149
2014,0,28307,Matt Every,267,116,151
2014,0,27895,Jonas Blixt,271,117,154
2014,0,24494,Erik Compton,276,138,138
2014,0,23800,Bryce Molder,277,158,119
2014,0,20593,Greg Chalmers,281,147,134
2014,0,25720,Chad Collins,287,172,115
2014,0,20160,Charlie Wi,289,146,143
2014,0,23409,James Driscoll,306,132,174
2014,0,10423,Mike Weir,349,176,173
2013,0,27436,Graham DeLaet,53,19,34
2013,0,33141,Keegan Bradley,72,11,61
2013,0,21528,Henrik Stenson,73,66,7
2013,0,22405,Justin Rose,79,27,52
2013,0,31557,Jim Herman,82,17,65
2013,0,29420,Billy Horschel,92,42,50
2013,0,26289,Boo Weekley,94,66,28
2013,0,24781,Hunter Mahan,98,73,25
2013,0,34046,Jordan Spieth,98,80,18
2013,0,23788,D.J. Trahan,99,46,53
2013,0,6573,Brandt Jobe,100,57,43
2013,0,26300,Matt Jones,101,56,45
2013,0,28780,Nicholas Thompson,105,60,45
2013,0,24502,Adam Scott,107,23,84
2013,0,23325,Vaughn Taylor,112,75,37
2013,0,27214,Kevin Streelman,117,94,23
2013,0,8793,Tiger Woods,118,49,69
2013,0,26679,Kevin Stadler,124,75,49
2013,0,6527,Steve Stricker,127,124,3
2013,0,25900,Lucas Glover,128,43,85
2013,0,34098,Russell Henley,130,83,47
2013,0,25804,Bubba Watson,131,5,126
2013,0,23638,Brendon de Jonge,133,104,29
2013,0,26476,Chez Reavie,134,128,6
2013,0,20396,Lee Westwood,135,69,66
2013,0,27095,Nick Watney,136,63,73
2013,0,32366,Kevin Chappell,139,52,87
2013,0,26331,Charl Schwartzel,139,29,110
2013,0,30110,Kyle Stanley,140,22,118
2013,0,34431,Robert Streb,140,24,116
2013,0,24490,George McNeill,142,106,36
2013,0,27330,Josh Teater,142,43,99
2013,0,32334,Charlie Beljan,143,32,111
2013,0,27936,Martin Laird,144,46,98
2013,0,30163,Henrik Norlander,145,36,109
2013,0,27503,Steve LeBrun,146,38,108
2013,0,26596,Ryan Moore,146,130,16
2013,0,34174,John Huh,147,133,14
2013,0,25686,Jason Dufner,148,107,41
2013,0,8725,Tom Gillis,148,104,44
2013,0,28237,Rory McIlroy,148,8,140
2013,0,34409,David Lingmerth,149,109,40
2013,0,31323,Gary Woodland,150,4,146
2013,0,32200,Roberto Castro,152,130,22
2013,0,29479,Scott Brown,154,78,76
2013,0,28089,Jason Day,154,16,138
2013,0,29518,Brendan Steele,154,68,86
2013,0,25444,Justin Hicks,155,146,9
2013,0,23320,Ryan Palmer,155,10,145
2013,0,21209,Sergio Garcia,156,64,92
2013,0,12716,Charley Hoffman,156,40,116
2013,0,33869,Eric Meierdierks,156,9,147
2013,0,30692,Scott Stallings,156,30,126
2013,0,33419,Cameron Tringale,157,98,59
2013,0,23353,J.J. Henry,158,119,39
2013,0,23623,Bo Van Pelt,158,107,51
2013,0,21878,Mark Wilson,160,158,2
2013,0,28679,Fabián Gómez,161,78,83
2013,0,24024,Zach Johnson,161,153,8
2013,0,27556,Ted Potter Jr.,161,144,17
2013,0,24361,Pat Perez,162,71,91
2013,0,22913,John Rollins,162,31,131
2013,0,29740,Brad Fritsch,163,26,137
2013,0,34099,Harris English,164,35,129
2013,0,23621,Rory Sabbatini,164,50,114
2013,0,20691,Greg Owen,165,53,112
2013,0,22056,Cameron Percy,165,45,120
2013,0,24663,Y.E. Yang,165,101,64
2013,0,21753,Brian Davis,166,153,13
2013,0,37273,Derek Ernst,166,61,105
2013,0,22806,Doug LaBelle II,166,145,21
2013,0,29221,Webb Simpson,166,111,55
2013,0,31560,Brian Stuard,166,134,32
2013,0,24924,Bill Haas,167,90,77
2013,0,6567,Vijay Singh,168,91,77
2013,0,29425,Andrew Svoboda,168,71,97
2013,0,24358,Robert Garrigus,169,7,162
2013,0,23452,Nicolas Colsaerts,170,3,167
2013,0,36884,Ben Kohles,170,151,19
2013,0,28092,D.H. Lee,170,140,30
2013,0,1320,Bob Estes,171,115,56
2013,0,1724,Jeff Maggert,171,160,11
2013,0,24140,Sean O'Hair,172,14,158
2013,0,10809,Jim Furyk,173,169,4
2013,0,30925,Dustin Johnson,173,2,171
2013,0,35139,Richard Lee,173,149,24
2013,0,33461,Morgan Hoffmann,175,32,143
2013,0,27408,Martin Kaymer,176,87,89
2013,0,25572,Graeme McDowell,176,161,15
2013,0,28455,Will Claxton,178,116,62
2013,0,32448,James Hahn,178,48,130
2013,0,8075,Jerry Kelly,178,177,1
2013,0,30944,Jason Kokrak,178,6,172
2013,0,23135,Tim Clark,180,175,5
2013,0,20104,Ken Duke,180,170,10
2013,0,28500,Martin Flores,180,12,168
2013,0,27129,Luke List,181,1,180
2013,0,32102,Rickie Fowler,183,103,80
2013,0,20645,John Senden,184,82,102
2013,0,12510,Chad Campbell,185,85,100
2013,0,23497,Tag Ridings,185,15,170
2013,0,24846,Ricky Barnes,186,80,106
2013,0,20098,Stuart Appleby,187,119,68
2013,0,25274,Steven Bowditch,187,13,174
2013,0,24357,K.J. Choi,187,156,31
2013,0,22792,Peter Hanson,188,34,154
2013,0,2206,David Toms,188,162,26
2013,0,20443,Jin Park,189,177,12
2013,0,25345,Carl Pettersson,189,70,119
2013,0,33418,Shawn Stefani,189,25,164
2013,0,25818,Scott Piercy,190,21,169
2013,0,22295,Darron Stiles,190,170,20
2013,0,27770,Camilo Villegas,190,59,131
2013,0,20160,Charlie Wi,190,132,58
2013,0,25834,Daniel Summerhays,191,110,81
2013,0,25240,D.A. Points,192,138,54
2013,0,27644,Brian Harman,195,94,101
2013,0,20848,Ángel Cabrera,196,40,156
2013,0,29289,S.Y. Noh,196,18,178
2013,0,25632,Jimmy Walker,196,20,176
2013,0,28475,Jeff Overton,197,55,142
2013,0,30926,Chris Kirk,198,83,115
2013,0,25562,Andres Romero,198,50,148
2013,0,27120,Troy Matteson,199,38,161
2013,0,24507,Jason Bohn,201,166,35
2013,0,20572,Rod Pampling,204,129,75
2013,0,27649,Brandt Snedeker,204,137,67
2013,0,24494,Erik Compton,205,54,151
2013,0,32698,Bobby Gates,205,28,177
2013,0,19970,Robert Karlsson,205,98,107
2013,0,30711,Colt Knost,206,179,27
2013,0,24138,Ian Poulter,207,136,71
2013,0,23800,Bryce Molder,209,176,33
2013,0,22046,Geoff Ogilvy,209,114,95
2013,0,21961,Charles Howell III,210,37,173
2013,0,19846,Brian Gay,212,170,42
2013,0,10213,Dicky Pride,212,174,38
2013,0,22961,David Mathis,213,142,71
2013,0,31202,William McGirt,213,134,79
2013,0,28307,Matt Every,214,91,123
2013,0,10860,Justin Leonard,214,166,48
2013,0,34360,Patrick Reed,215,58,157
2013,0,34021,Bud Cauley,216,94,122
2013,0,23983,Luke Donald,217,157,60
2013,0,30750,Tommy Gainey,217,64,153
2013,0,22378,Trevor Immelman,218,124,94
2013,0,6522,Ernie Els,220,77,143
2013,0,35539,Luke Guthrie,220,127,93
2013,0,28135,Aaron Watkins,220,163,57
2013,0,24399,Scott Gardiner,221,87,134
2013,0,30852,Ryo Ishikawa,221,62,159
2013,0,34261,Scott Langley,222,152,70
2013,0,20229,Stewart Cink,223,73,150
2013,0,20766,Padraig Harrington,224,89,135
2013,0,27933,John Merrick,226,122,104
2013,0,20593,Greg Chalmers,227,165,62
2013,0,26851,Marc Leishman,227,102,125
2013,0,26758,David Hearn,228,147,81
2013,0,23541,Ben Crane,234,139,95
2013,0,32150,Michael Thompson,236,148,88
2013,0,27963,Chris Stroud,237,164,73
2013,0,24227,Justin Bolli,238,149,89
2013,0,23108,Matt Kuchar,240,116,124
2013,0,1810,Phil Mickelson,242,93,149
2013,0,28259,Sangmoon Bae,247,112,135
2013,0,21731,Freddie Jacobson,252,97,155
2013,0,10885,Robert Allenby,257,116,141
2013,0,25336,Alistair Presnell,260,121,139
2013,0,22371,Aaron Baddeley,265,86,179
2013,0,23409,James Driscoll,266,100,166
2013,0,1116,Michael Bradley,272,112,160
2013,0,6004,Stephen Ames,274,141,133
2013,0,27895,Jonas Blixt,275,123,152
2013,0,22621,Ben Curtis,276,173,103
2013,0,21099,David Lynn,280,159,121
2013,0,28310,Lee Williams,280,168,112
2013,0,26951,Johnson Wagner,283,155,128
2013,0,12782,Tim Herron,299,124,175
2013,0,26497,Casey Wittenberg,308,143,165
2013,0,10423,Mike Weir,343,180,163
2012,0,26289,Boo Weekley,74,36,38
2012,0,24781,Hunter Mahan,78,61,17
2012,0,23623,Bo Van Pelt,84,40,44
2012,0,11123,Chris Couch,85,54,31
2012,0,25686,Jason Dufner,85,64,21
2012,0,8793,Tiger Woods,87,32,55
2012,0,26329,Louis Oosthuizen,90,23,67
2012,0,6573,Brandt Jobe,91,25,66
2012,0,22913,John Rollins,98,47,51
2012,0,26679,Kevin Stadler,102,62,40
2012,0,33141,Keegan Bradley,103,16,87
2012,0,20645,John Senden,103,79,24
2012,0,27933,John Merrick,105,58,47
2012,0,20396,Lee Westwood,105,29,76
2012,0,32102,Rickie Fowler,108,60,48
2012,0,22405,Justin Rose,108,80,28
2012,0,29420,Billy Horschel,111,89,22
2012,0,32200,Roberto Castro,117,83,34
2012,0,28455,Will Claxton,119,85,34
2012,0,12716,Charley Hoffman,119,46,73
2012,0,27644,Brian Harman,120,87,33
2012,0,24924,Bill Haas,122,66,56
2012,0,27436,Graham DeLaet,123,13,110
2012,0,27330,Josh Teater,123,27,96
2012,0,34174,John Huh,124,113,11
2012,0,8725,Tom Gillis,126,103,23
2012,0,30110,Kyle Stanley,132,8,124
2012,0,24502,Adam Scott,133,10,123
2012,0,33419,Cameron Tringale,134,85,49
2012,0,26331,Charl Schwartzel,135,42,93
2012,0,25804,Bubba Watson,136,1,135
2012,0,6567,Vijay Singh,137,47,90
2012,0,29910,Blake Adams,139,112,27
2012,0,32334,Charlie Beljan,141,2,139
2012,0,25572,Graeme McDowell,141,136,5
2012,0,35139,Richard Lee,144,134,10
2012,0,24361,Pat Perez,144,75,69
2012,0,34099,Harris English,145,20,125
2012,0,26596,Ryan Moore,146,117,29
2012,0,29289,S.Y. Noh,146,19,127
2012,0,24140,Sean O'Hair,149,31,118
2012,0,21528,Henrik Stenson,149,96,53
2012,0,28475,Jeff Overton,150,68,82
2012,0,33122,Russell Knox,152,132,20
2012,0,27214,Kevin Streelman,152,63,89
2012,0,20691,Greg Owen,156,41,115
2012,0,27936,Martin Laird,157,28,129
2012,0,30692,Scott Stallings,157,17,140
2012,0,32698,Bobby Gates,158,21,137
2012,0,1766,Billy Mayfair,158,122,36
2012,0,23320,Ryan Palmer,159,15,144
2012,0,24358,Robert Garrigus,160,3,157
2012,0,1724,Jeff Maggert,160,141,19
2012,0,28237,Rory McIlroy,161,5,156
2012,0,23788,D.J. Trahan,161,66,95
2012,0,21209,Sergio Garcia,162,64,98
2012,0,30925,Dustin Johnson,162,4,158
2012,0,29518,Brendan Steele,163,105,58
2012,0,23638,Brendon de Jonge,164,105,59
2012,0,27770,Camilo Villegas,165,87,78
2012,0,22046,Geoff Ogilvy,168,90,78
2012,0,1706,Davis Love III,169,39,130
2012,0,20572,Rod Pampling,169,105,64
2012,0,23108,Matt Kuchar,170,128,42
2012,0,27095,Nick Watney,170,36,134
2012,0,24494,Erik Compton,171,33,138
2012,0,23541,Ben Crane,172,122,50
2012,0,27302,Garth Mulroy,172,55,117
2012,0,23204,Gary Christian,173,164,9
2012,0,1249,John Daly,173,9,164
2012,0,25818,Scott Piercy,173,12,161
2012,0,28087,Kris Blanks,174,148,26
2012,0,26476,Chez Reavie,174,161,13
2012,0,20848,Ángel Cabrera,175,22,153
2012,0,10809,Jim Furyk,175,171,4
2012,0,20766,Padraig Harrington,177,57,120
2012,0,29476,Kyle Reifers,177,92,85
2012,0,22293,Heath Slocum,177,175,2
2012,0,23353,J.J. Henry,178,115,63
2012,0,27141,J.B. Holmes,179,6,173
2012,0,26287,Roland Thatcher,179,104,75
2012,0,24024,Zach Johnson,182,168,14
2012,0,27060,John Mallinger,182,166,16
2012,0,25834,Daniel Summerhays,182,101,81
2012,0,23135,Tim Clark,183,180,3
2012,0,8075,Jerry Kelly,183,182,1
2012,0,25345,Carl Pettersson,183,35,148
2012,0,24138,Ian Poulter,184,145,39
2012,0,34021,Bud Cauley,186,74,112
2012,0,25892,Steve Wheatcroft,189,121,68
2012,0,29479,Scott Brown,190,77,113
2012,0,20104,Ken Duke,190,160,30
2012,0,30944,Jason Kokrak,190,14,176
2012,0,25396,Kevin Na,190,165,25
2012,0,2206,David Toms,190,184,6
2012,0,27064,Jhonattan Vegas,190,10,180
2012,0,31323,Gary Woodland,190,18,172
2012,0,20098,Stuart Appleby,191,159,32
2012,0,28089,Jason Day,191,7,184
2012,0,22621,Ben Curtis,193,186,7
2012,0,30926,Chris Kirk,194,73,121
2012,0,21878,Mark Wilson,195,183,12
2012,0,6251,Chris DiMarco,196,188,8
2012,0,26758,David Hearn,196,124,72
2012,0,21753,Brian Davis,197,179,18
2012,0,25240,D.A. Points,197,152,45
2012,0,27963,Chris Stroud,197,126,71
2012,0,30750,Tommy Gainey,198,33,165
2012,0,6527,Steve Stricker,199,138,61
2012,0,21805,Harrison Frazar,200,30,170
2012,0,27556,Ted Potter Jr.,200,148,52
2012,0,24604,Hunter Haas,201,117,84
2012,0,22378,Trevor Immelman,201,80,121
2012,0,29221,Webb Simpson,203,111,92
2012,0,12510,Chad Campbell,204,90,114
2012,0,30711,Colt Knost,204,189,15
2012,0,24490,George McNeill,204,105,99
2012,0,25457,Alexandre Rocha,204,147,57
2012,0,6522,Ernie Els,206,51,155
2012,0,28308,Troy Kelly,206,23,183
2012,0,23983,Luke Donald,207,170,37
2012,0,24940,Edward Loar,207,44,163
2012,0,24846,Ricky Barnes,208,68,140
2012,0,27120,Troy Matteson,208,26,182
2012,0,6036,Scott Dunlap,211,166,45
2012,0,32366,Kevin Chappell,212,58,154
2012,0,23548,Bill Lunde,215,84,131
2012,0,24357,K.J. Choi,216,162,54
2012,0,22582,Kyle Thompson,216,151,65
2012,0,24507,Jason Bohn,217,174,43
2012,0,19970,Robert Karlsson,217,50,167
2012,0,29478,Kevin Kisner,217,116,101
2012,0,12782,Tim Herron,218,99,119
2012,0,27649,Brandt Snedeker,219,110,109
2012,0,25632,Jimmy Walker,219,38,181
2012,0,26300,Matt Jones,221,55,166
2012,0,20160,Charlie Wi,221,134,87
2012,0,21961,Charles Howell III,222,51,171
2012,0,29926,Danny Lee,222,72,150
2012,0,23621,Rory Sabbatini,222,119,103
2012,0,26951,Johnson Wagner,222,152,70
2012,0,10213,Dicky Pride,224,130,94
2012,0,28500,Martin Flores,226,49,177
2012,0,1810,Phil Mickelson,227,53,174
2012,0,12652,Cameron Beckman,228,142,86
2012,0,33120,Mark Anderson,229,43,186
2012,0,20574,Mathew Goggin,229,82,147
2012,0,20623,Gavin Coles,231,190,41
2012,0,20850,Daniel Chopra,235,44,191
2012,0,23325,Vaughn Taylor,235,129,106
2012,0,28259,Sangmoon Bae,237,95,142
2012,0,25562,Andres Romero,237,68,169
2012,0,6004,Stephen Ames,238,155,83
2012,0,22961,David Mathis,238,176,62
2012,0,28307,Matt Every,240,136,104
2012,0,24925,Jonathan Byrd,241,96,145
2012,0,28093,Miguel Angel Carballo,241,96,145
2012,0,22371,Aaron Baddeley,243,68,175
2012,0,20593,Greg Chalmers,243,163,80
2012,0,1797,Rocco Mediate,243,169,74
2012,0,21407,Arjun Atwal,244,144,100
2012,0,31202,William McGirt,245,138,107
2012,0,1320,Bob Estes,247,142,105
2012,0,24663,Y.E. Yang,248,146,102
2012,0,10885,Robert Allenby,251,124,127
2012,0,22348,Nick O'Hern,251,191,60
2012,0,19846,Brian Gay,254,177,77
2012,0,31558,J.J. Killeen,254,94,160
2012,0,27895,Jonas Blixt,260,127,133
2012,0,21731,Freddie Jacobson,262,119,143
2012,0,23903,Stephen Gangluff,265,75,190
2012,0,23409,James Driscoll,267,78,189
2012,0,26851,Marc Leishman,267,99,168
2012,0,23800,Bryce Molder,269,178,91
2012,0,30852,Ryo Ishikawa,271,92,179
2012,0,27974,Sung Kang,282,133,149
2012,0,20229,Stewart Cink,283,105,178
2012,0,10860,Justin Leonard,283,172,111
2012,0,1941,Tom Pernice Jr.,284,187,97
2012,0,32150,Michael Thompson,284,158,126
2012,0,23718,Nathan Green,286,154,132
2012,0,27797,Derek Lamely,289,102,187
2012,0,22548,Patrick Sheehan,289,173,116
2012,0,23542,Tommy Biershenk,290,138,152
2012,0,6034,Marco Dawson,292,130,162
2012,0,29222,Billy Hurley III,293,185,108
2012,0,30927,Brendon Todd,293,157,136
2012,0,20070,Matt Bettencourt,299,114,185
2012,0,27466,Spencer Levin,306,155,151
2012,0,1116,Michael Bradley,336,148,188
2012,0,21350,Ryuji Imada,340,181,159
2011,0,27933,John Merrick,66,41,25
2011,0,22913,John Rollins,74,46,28
2011,0,6573,Brandt Jobe,76,33,43
2011,0,26289,Boo Weekley,79,48,31
2011,0,24502,Adam Scott,86,24,62
2011,0,11123,Chris Couch,93,44,49
2011,0,26476,Chez Reavie,95,71,24
2011,0,20645,John Senden,101,72,29
2011,0,23623,Bo Van Pelt,105,38,67
2011,0,27330,Josh Teater,113,15,98
2011,0,24924,Bill Haas,115,48,67
2011,0,33141,Keegan Bradley,116,20,96
2011,0,20572,Rod Pampling,116,84,32
2011,0,29910,Blake Adams,125,80,45
2011,0,29518,Brendan Steele,127,77,50
2011,0,23353,J.J. Henry,128,92,36
2011,0,20498,Briny Baird,129,112,17
2011,0,29420,Billy Horschel,133,94,39
2011,0,30110,Kyle Stanley,133,9,124
2011,0,12716,Charley Hoffman,136,22,114
2011,0,10585,Scott McCarron,138,84,54
2011,0,26331,Charl Schwartzel,138,43,95
2011,0,31323,Gary Woodland,142,5,137
2011,0,29221,Webb Simpson,143,51,92
2011,0,25444,Justin Hicks,145,132,13
2011,0,27936,Martin Laird,147,13,134
2011,0,25572,Graeme McDowell,147,109,38
2011,0,1313,Steve Elkington,149,135,14
2011,0,26679,Kevin Stadler,149,74,75
2011,0,30925,Dustin Johnson,150,3,147
2011,0,6621,Joe Durant,152,151,1
2011,0,23788,D.J. Trahan,152,31,121
2011,0,27095,Nick Watney,152,16,136
2011,0,27120,Troy Matteson,153,21,132
2011,0,34072,Will Strickler,154,10,144
2011,0,25804,Bubba Watson,154,2,152
2011,0,32698,Bobby Gates,155,38,117
2011,0,24361,Pat Perez,156,90,66
2011,0,25240,D.A. Points,157,122,35
2011,0,1706,Davis Love III,158,33,125
2011,0,7867,Woody Austin,160,120,40
2011,0,24507,Jason Bohn,160,139,21
2011,0,27974,Sung Kang,161,68,93
2011,0,25818,Scott Piercy,161,7,154
2011,0,8725,Tom Gillis,162,103,59
2011,0,1766,Billy Mayfair,162,153,9
2011,0,23497,Tag Ridings,162,12,150
2011,0,21753,Brian Davis,163,153,10
2011,0,21878,Mark Wilson,163,143,20
2011,0,30692,Scott Stallings,164,11,153
2011,0,12510,Chad Campbell,165,92,73
2011,0,23541,Ben Crane,165,139,26
2011,0,22293,Heath Slocum,165,163,2
2011,0,28158,Steve Marino,166,59,107
2011,0,21209,Sergio Garcia,167,28,139
2011,0,25900,Lucas Glover,167,63,104
2011,0,24781,Hunter Mahan,167,84,83
2011,0,26758,David Hearn,168,96,72
2011,0,25345,Carl Pettersson,168,81,87
2011,0,25686,Jason Dufner,169,125,44
2011,0,31557,Jim Herman,169,18,151
2011,0,28620,Aron Price,169,158,11
2011,0,28475,Jeff Overton,170,58,112
2011,0,31193,Jim Renner,171,44,127
2011,0,6004,Stephen Ames,172,150,22
2011,0,29720,Andres Gonzales,172,75,97
2011,0,33419,Cameron Tringale,172,66,106
2011,0,31401,Zack Miller,173,25,148
2011,0,22405,Justin Rose,173,99,74
2011,0,24980,Scott Gutschewski,174,36,138
2011,0,25274,Steven Bowditch,175,6,169
2011,0,30750,Tommy Gainey,176,46,130
2011,0,30946,Alex Prugh,176,31,145
2011,0,27214,Kevin Streelman,176,111,65
2011,0,26287,Roland Thatcher,177,75,102
2011,0,24604,Hunter Haas,178,114,64
2011,0,10733,Kent Jones,178,137,41
2011,0,23638,Brendon de Jonge,179,119,60
2011,0,34255,Joseph Bramlett,180,57,123
2011,0,23108,Matt Kuchar,180,128,52
2011,0,33413,Ben Martin,180,109,71
2011,0,24490,George McNeill,180,60,120
2011,0,26596,Ryan Moore,180,103,77
2011,0,10885,Robert Allenby,181,100,81
2011,0,2206,David Toms,181,175,6
2011,0,27064,Jhonattan Vegas,181,8,173
2011,0,32102,Rickie Fowler,182,25,157
2011,0,10809,Jim Furyk,182,164,18
2011,0,1577,Lee Janzen,182,103,79
2011,0,27141,J.B. Holmes,183,1,182
2011,0,21961,Charles Howell III,183,40,143
2011,0,19970,Robert Karlsson,183,28,155
2011,0,26951,Johnson Wagner,183,160,23
2011,0,32366,Kevin Chappell,184,55,129
2011,0,24358,Robert Garrigus,184,4,180
2011,0,25457,Alexandre Rocha,184,96,88
2011,0,22621,Ben Curtis,185,180,5
2011,0,24024,Zach Johnson,185,177,8
2011,0,27649,Brandt Snedeker,185,124,61
2011,0,28089,Jason Day,186,14,172
2011,0,8075,Jerry Kelly,186,183,3
2011,0,20127,Chris Riley,186,174,12
2011,0,22046,Geoff Ogilvy,188,106,82
2011,0,6567,Vijay Singh,188,66,122
2011,0,24663,Y.E. Yang,188,100,88
2011,0,20848,Ángel Cabrera,189,19,170
2011,0,22348,Nick O'Hern,189,182,7
2011,0,19846,Brian Gay,190,186,4
2011,0,22961,David Mathis,190,161,29
2011,0,27939,Matt McQuillan,190,135,55
2011,0,20436,Garrett Willis,190,171,19
2011,0,23614,Rich Beem,192,129,63
2011,0,23548,Bill Lunde,192,89,103
2011,0,28679,Fabián Gómez,194,116,78
2011,0,10505,Shane Bertsch,195,168,27
2011,0,23800,Bryce Molder,195,161,34
2011,0,23409,James Driscoll,196,33,163
2011,0,27466,Spencer Levin,196,127,69
2011,0,6527,Steve Stricker,198,113,85
2011,0,24925,Jonathan Byrd,199,84,115
2011,0,1810,Phil Mickelson,199,22,177
2011,0,6643,Paul Goydos,200,185,15
2011,0,1797,Rocco Mediate,200,184,16
2011,0,21805,Harrison Frazar,201,17,184
2011,0,23320,Ryan Palmer,201,25,176
2011,0,25562,Andres Romero,202,61,141
2011,0,20472,Alex Cejka,204,167,37
2011,0,23983,Luke Donald,204,147,57
2011,0,24846,Ricky Barnes,205,72,133
2011,0,23325,Vaughn Taylor,205,147,58
2011,0,27770,Camilo Villegas,205,65,140
2011,0,20157,Retief Goosen,206,107,99
2011,0,24138,Ian Poulter,206,155,51
2011,0,22378,Trevor Immelman,208,114,94
2011,0,25632,Jimmy Walker,208,30,178
2011,0,27963,Chris Stroud,210,91,119
2011,0,32150,Michael Thompson,210,94,116
2011,0,6251,Chris DiMarco,211,178,33
2011,0,28486,Michael Putnam,212,41,171
2011,0,8537,J.P. Hayes,213,157,56
2011,0,28087,Kris Blanks,215,139,76
2011,0,10860,Justin Leonard,215,168,47
2011,0,32640,Troy Merritt,215,125,90
2011,0,22371,Aaron Baddeley,217,51,166
2011,0,30926,Chris Kirk,217,56,161
2011,0,23673,Michael Connell,218,173,45
2011,0,30711,Colt Knost,218,176,42
2011,0,31202,William McGirt,218,107,111
2011,0,1948,Tim Petrovic,219,166,53
2011,0,27797,Derek Lamely,222,37,185
2011,0,25834,Daniel Summerhays,223,139,84
2011,0,24357,K.J. Choi,225,134,91
2011,0,12782,Tim Herron,227,81,146
2011,0,24140,Sean O'Hair,227,63,164
2011,0,12602,Dean Wilson,227,179,48
2011,0,26851,Marc Leishman,228,54,174
2011,0,21731,Freddie Jacobson,232,122,110
2011,0,9011,David Duval,233,50,183
2011,0,35087,Bio Kim,234,53,181
2011,0,23621,Rory Sabbatini,234,78,156
2011,0,20160,Charlie Wi,234,133,101
2011,0,6522,Ernie Els,235,118,117
2011,0,26668,Marc Turnesa,235,155,80
2011,0,26300,Matt Jones,237,70,167
2011,0,20229,Stewart Cink,240,81,159
2011,0,20766,Padraig Harrington,240,61,179
2011,0,21949,Joe Ogilvie,242,84,158
2011,0,1116,Michael Bradley,247,98,149
2011,0,12652,Cameron Beckman,249,145,104
2011,0,26420,Richard Johnson,251,181,70
2011,0,29718,Anthony Kim,254,68,186
2011,0,29478,Kevin Kisner,254,145,109
2011,0,32876,Martin Piller,254,79,175
2011,0,20098,Stuart Appleby,256,121,135
2011,0,20593,Greg Chalmers,258,172,86
2011,0,7457,Steve Flesch,259,159,100
2011,0,26881,Jarrod Lyle,260,129,131
2011,0,23718,Nathan Green,263,137,126
2011,0,21350,Ryuji Imada,265,152,113
2011,0,24290,D.J. Brigman,268,100,168
2011,0,33911,Nate Smith,272,165,107
2011,0,20070,Matt Bettencourt,277,117,160
2011,0,8375,Paul Stankowski,277,149,128
2011,0,6515,Shaun Micheel,294,129,165
2011,0,21407,Arjun Atwal,305,143,162
2011,0,25396,Kevin Na,312,170,142
2010,0,23349,Charles Warren,70,9,61
2010,0,27436,Graham DeLaet,84,6,78
2010,0,24781,Hunter Mahan,95,57,38
2010,0,1706,Davis Love III,102,17,85
2010,0,26289,Boo Weekley,102,55,47
2010,0,1945,Kenny Perry,104,68,36
2010,0,22913,John Rollins,110,30,80
2010,0,11123,Chris Couch,111,49,62
2010,0,26596,Ryan Moore,111,75,36
2010,0,27933,John Merrick,113,60,53
2010,0,29910,Blake Adams,115,63,52
2010,0,1313,Steve Elkington,115,80,35
2010,0,8725,Tom Gillis,115,86,29
2010,0,6621,Joe Durant,118,116,2
2010,0,20645,John Senden,118,72,46
2010,0,23353,J.J. Henry,120,46,74
2010,0,26881,Jarrod Lyle,122,23,99
2010,0,20378,Mathias Grönberg,123,40,83
2010,0,24912,Will MacKenzie,123,66,57
2010,0,23623,Bo Van Pelt,123,53,70
2010,0,28237,Rory McIlroy,127,12,115
2010,0,24924,Bill Haas,130,42,88
2010,0,10585,Scott McCarron,131,88,43
2010,0,32102,Rickie Fowler,133,47,86
2010,0,27214,Kevin Streelman,134,70,64
2010,0,20157,Retief Goosen,136,60,76
2010,0,27095,Nick Watney,136,20,116
2010,0,25900,Lucas Glover,138,27,111
2010,0,8375,Paul Stankowski,138,70,68
2010,0,10425,Jay Williamson,139,119,20
2010,0,20229,Stewart Cink,141,49,92
2010,0,1766,Billy Mayfair,141,124,17
2010,0,27330,Josh Teater,141,44,97
2010,0,21209,Sergio Garcia,142,47,95
2010,0,12716,Charley Hoffman,143,15,128
2010,0,24502,Adam Scott,143,33,110
2010,0,23788,D.J. Trahan,143,10,133
2010,0,12510,Chad Campbell,144,119,25
2010,0,23108,Matt Kuchar,144,105,39
2010,0,23541,Ben Crane,145,136,9
2010,0,6595,Kevin Sutherland,145,96,49
2010,0,20574,Mathew Goggin,147,78,69
2010,0,2206,David Toms,151,144,7
2010,0,6567,Vijay Singh,153,51,102
2010,0,23325,Vaughn Taylor,155,122,33
2010,0,12705,Cliff Kresge,156,128,28
2010,0,10885,Robert Allenby,159,82,77
2010,0,28087,Kris Blanks,161,110,51
2010,0,25686,Jason Dufner,164,140,24
2010,0,24024,Zach Johnson,164,156,8
2010,0,27936,Martin Laird,164,20,144
2010,0,27120,Troy Matteson,164,22,142
2010,0,6527,Steve Stricker,164,134,30
2010,0,28620,Aron Price,166,121,45
2010,0,23322,Brett Wetterich,166,4,162
2010,0,27302,Garth Mulroy,167,29,138
2010,0,20436,Garrett Willis,167,153,14
2010,0,25364,Paul Casey,169,35,134
2010,0,22405,Justin Rose,169,97,72
2010,0,22293,Heath Slocum,169,163,6
2010,0,23638,Brendon de Jonge,170,105,65
2010,0,24140,Sean O'Hair,170,78,92
2010,0,24663,Y.E. Yang,170,88,82
2010,0,22946,Henrik Bjornstad,171,93,78
2010,0,23307,Roger Tambellini,171,53,118
2010,0,28780,Nicholas Thompson,171,80,91
2010,0,24361,Pat Perez,172,102,70
2010,0,8075,Jerry Kelly,173,160,13
2010,0,26695,Michael Letzig,173,75,98
2010,0,30925,Dustin Johnson,175,3,172
2010,0,27060,John Mallinger,175,152,23
2010,0,26301,James Nitties,175,112,63
2010,0,24358,Robert Garrigus,176,1,175
2010,0,21878,Mark Wilson,176,150,26
2010,0,28089,Jason Day,178,15,163
2010,0,6251,Chris DiMarco,178,160,18
2010,0,1619,Skip Kendall,178,157,21
2010,0,25804,Bubba Watson,178,2,176
2010,0,26679,Kevin Stadler,180,72,108
2010,0,12602,Dean Wilson,183,142,41
2010,0,22371,Aaron Baddeley,184,14,170
2010,0,30946,Alex Prugh,185,27,158
2010,0,26420,Richard Johnson,186,175,11
2010,0,28307,Matt Every,187,64,123
2010,0,27141,J.B. Holmes,188,5,183
2010,0,20472,Alex Cejka,189,173,16
2010,0,10809,Jim Furyk,189,179,10
2010,0,33419,Cameron Tringale,189,32,157
2010,0,20848,Ángel Cabrera,190,8,182
2010,0,26851,Marc Leishman,190,31,159
2010,0,20691,Greg Owen,190,60,130
2010,0,23320,Ryan Palmer,190,26,164
2010,0,8385,Omar Uresti,190,189,1
2010,0,24357,K.J. Choi,191,131,60
2010,0,25892,Steve Wheatcroft,191,102,89
2010,0,23135,Tim Clark,192,188,4
2010,0,28158,Steve Marino,192,68,124
2010,0,20572,Rod Pampling,192,126,66
2010,0,22056,Cameron Percy,192,36,156
2010,0,25818,Scott Piercy,192,19,173
2010,0,6004,Stephen Ames,193,138,55
2010,0,24925,Jonathan Byrd,193,64,129
2010,0,21753,Brian Davis,194,163,31
2010,0,20105,Jeff Gove,194,86,108
2010,0,10860,Justin Leonard,194,172,22
2010,0,1249,John Daly,195,6,189
2010,0,19846,Brian Gay,195,192,3
2010,0,28475,Jeff Overton,195,18,177
2010,0,7363,Craig Bowden,196,191,5
2010,0,20127,Chris Riley,196,169,27
2010,0,6643,Paul Goydos,197,185,12
2010,0,24227,Justin Bolli,199,141,58
2010,0,1724,Jeff Maggert,199,159,40
2010,0,12714,Chris Tidland,199,93,106
2010,0,22378,Trevor Immelman,200,110,90
2010,0,7867,Woody Austin,201,147,54
2010,0,20070,Matt Bettencourt,201,36,165
2010,0,22621,Ben Curtis,201,182,19
2010,0,1810,Phil Mickelson,201,13,188
2010,0,25190,Jeff Quinney,201,186,15
2010,0,2239,Scott Verplank,201,167,34
2010,0,1797,Rocco Mediate,202,170,32
2010,0,1941,Tom Pernice Jr.,202,154,48
2010,0,25562,Andres Romero,202,24,178
2010,0,28500,Martin Flores,203,11,192
2010,0,27770,Camilo Villegas,203,77,126
2010,0,20498,Briny Baird,204,138,66
2010,0,24507,Jason Bohn,204,155,49
2010,0,22122,Andrew McLardy,205,74,131
2010,0,21959,Ted Purdy,205,66,139
2010,0,1948,Tim Petrovic,206,165,41
2010,0,23409,James Driscoll,207,39,168
2010,0,26392,Chris Wilson,207,58,149
2010,0,27963,Chris Stroud,208,101,107
2010,0,26300,Matt Jones,209,42,167
2010,0,31560,Brian Stuard,210,105,105
2010,0,12652,Cameron Beckman,211,115,96
2010,0,25240,D.A. Points,214,133,81
2010,0,21961,Charles Howell III,215,34,181
2010,0,20850,Daniel Chopra,216,25,191
2010,0,27797,Derek Lamely,216,36,180
2010,0,20766,Padraig Harrington,221,52,169
2010,0,23548,Bill Lunde,222,85,137
2010,0,24138,Ian Poulter,222,109,113
2010,0,8537,J.P. Hayes,223,148,75
2010,0,27466,Spencer Levin,223,150,73
2010,0,25396,Kevin Na,223,167,56
2010,0,29285,Brent Delahoussaye,225,181,44
2010,0,24490,George McNeill,225,41,184
2010,0,23621,Rory Sabbatini,225,82,143
2010,0,27613,David Lutterus,226,55,171
2010,0,26882,Michael Sim,228,127,101
2010,0,7457,Steve Flesch,232,173,59
2010,0,20160,Charlie Wi,232,146,86
2010,0,25632,Jimmy Walker,235,45,190
2010,0,20098,Stuart Appleby,236,84,152
2010,0,20686,Jeev Milkha Singh,236,100,136
2010,0,6522,Ernie Els,237,90,147
2010,0,1707,Steve Lowery,237,112,125
2010,0,6515,Shaun Micheel,242,128,114
2010,0,23673,Michael Connell,243,144,99
2010,0,26287,Roland Thatcher,243,95,148
2010,0,12782,Tim Herron,244,58,186
2010,0,32640,Troy Merritt,246,92,154
2010,0,1577,Lee Janzen,248,98,150
2010,0,25345,Carl Pettersson,249,137,112
2010,0,26951,Johnson Wagner,252,135,117
2010,0,21731,Freddie Jacobson,253,131,122
2010,0,1320,Bob Estes,257,125,132
2010,0,29221,Webb Simpson,258,118,140
2010,0,27649,Brandt Snedeker,260,176,84
2010,0,22046,Geoff Ogilvy,265,104,161
2010,0,1161,Mark Calcavecchia,269,148,121
2010,0,21350,Ryuji Imada,269,165,104
2010,0,21949,Joe Ogilvie,269,114,155
2010,0,20663,Brenden Pappas,269,90,179
2010,0,9011,David Duval,271,105,166
2010,0,6514,Kevin Johnson,272,178,94
2010,0,23800,Bryce Molder,274,171,103
2010,0,7749,Brett Quigley,274,128,146
2010,0,24846,Ricky Barnes,276,117,159
2010,0,1116,Michael Bradley,284,143,141
2010,0,23613,Rich Barcelo,286,99,187
2010,0,32617,Jerod Turner,286,160,126
2010,0,23718,Nathan Green,292,157,135
2010,0,23983,Luke Donald,297,177,120
2010,0,12755,Vance Veazey,297,123,174
2010,0,6012,Greg Kraft,306,187,119
2010,0,25720,Chad Collins,324,180,144
2010,0,20593,Greg Chalmers,333,182,151
2010,0,1329,Brad Faxon,343,190,153
2010,0,10423,Mike Weir,369,184,185
2009,0,24925,Jonathan Byrd,92,33,59
2009,0,25900,Lucas Glover,95,25,70
2009,0,1945,Kenny Perry,97,48,49
2009,0,22913,John Rollins,97,30,67
2009,0,10885,Robert Allenby,98,48,50
2009,0,26289,Boo Weekley,98,62,36
2009,0,24781,Hunter Mahan,102,28,74
2009,0,26596,Ryan Moore,104,33,71
2009,0,20691,Greg Owen,104,59,45
2009,0,22293,Heath Slocum,104,97,7
2009,0,2214,Kirk Triplett,105,100,5
2009,0,8793,Tiger Woods,107,21,86
2009,0,23349,Charles Warren,111,18,93
2009,0,10585,Scott McCarron,117,114,3
2009,0,20645,John Senden,118,40,78
2009,0,6197,Michael Allen,119,80,39
2009,0,27936,Martin Laird,121,14,107
2009,0,1724,Jeff Maggert,121,83,38
2009,0,28087,Kris Blanks,122,65,57
2009,0,2206,David Toms,123,119,4
2009,0,23623,Bo Van Pelt,124,56,68
2009,0,24507,Jason Bohn,126,108,18
2009,0,23788,D.J. Trahan,126,79,47
2009,0,1035,Tommy Armour III,129,95,34
2009,0,28780,Nicholas Thompson,129,38,91
2009,0,20574,Mathew Goggin,131,69,62
2009,0,22892,Jason Gore,132,72,60
2009,0,24924,Bill Haas,132,22,110
2009,0,21959,Ted Purdy,134,45,89
2009,0,28158,Steve Marino,139,35,104
2009,0,1766,Billy Mayfair,139,119,20
2009,0,24912,Will MacKenzie,140,78,62
2009,0,1313,Steve Elkington,142,107,35
2009,0,1707,Steve Lowery,143,74,69
2009,0,28118,Peter Tomasulo,144,50,94
2009,0,6522,Ernie Els,145,68,77
2009,0,27120,Troy Matteson,146,9,137
2009,0,21878,Mark Wilson,146,118,28
2009,0,25686,Jason Dufner,148,102,46
2009,0,23548,Bill Lunde,149,57,92
2009,0,10425,Jay Williamson,149,123,26
2009,0,23541,Ben Crane,150,109,41
2009,0,23135,Tim Clark,152,150,2
2009,0,24024,Zach Johnson,153,143,10
2009,0,27933,John Merrick,154,29,125
2009,0,23320,Ryan Palmer,154,26,128
2009,0,10860,Justin Leonard,155,123,32
2009,0,21209,Sergio Garcia,156,18,138
2009,0,2239,Scott Verplank,156,145,11
2009,0,1706,Davis Love III,157,14,143
2009,0,6527,Steve Stricker,157,104,53
2009,0,6621,Joe Durant,158,157,1
2009,0,26851,Marc Leishman,158,17,141
2009,0,27214,Kevin Streelman,159,30,129
2009,0,24503,Jeff Klauk,160,147,13
2009,0,26498,Matt Weibring,160,84,76
2009,0,27095,Nick Watney,161,6,155
2009,0,24358,Robert Garrigus,162,1,161
2009,0,22548,Patrick Sheehan,162,146,16
2009,0,20160,Charlie Wi,164,112,52
2009,0,22295,Darron Stiles,165,153,12
2009,0,6004,Stephen Ames,167,94,73
2009,0,20472,Alex Cejka,167,143,24
2009,0,12716,Charley Hoffman,167,11,156
2009,0,10733,Kent Jones,168,141,27
2009,0,24140,Sean O'Hair,169,46,123
2009,0,23497,Tag Ridings,169,4,165
2009,0,22405,Justin Rose,169,90,79
2009,0,23353,J.J. Henry,171,44,127
2009,0,28089,Jason Day,172,36,136
2009,0,30925,Dustin Johnson,172,3,169
2009,0,6567,Vijay Singh,172,41,131
2009,0,27963,Chris Stroud,172,72,100
2009,0,26951,Johnson Wagner,172,88,84
2009,0,12510,Chad Campbell,173,70,103
2009,0,26476,Chez Reavie,173,154,19
2009,0,26301,James Nitties,174,63,111
2009,0,20127,Chris Riley,176,167,9
2009,0,27770,Camilo Villegas,176,50,126
2009,0,1320,Bob Estes,177,137,40
2009,0,10809,Jim Furyk,177,152,25
2009,0,30711,Colt Knost,177,154,23
2009,0,26695,Michael Letzig,177,43,134
2009,0,21753,Brian Davis,178,127,51
2009,0,25240,D.A. Points,178,141,37
2009,0,25818,Scott Piercy,179,12,167
2009,0,25804,Bubba Watson,180,2,178
2009,0,21805,Harrison Frazar,182,10,172
2009,0,31323,Gary Woodland,182,5,177
2009,0,1142,Bart Bryant,183,175,8
2009,0,20850,Daniel Chopra,185,26,159
2009,0,24502,Adam Scott,185,37,148
2009,0,23325,Vaughn Taylor,185,129,56
2009,0,20498,Briny Baird,186,138,48
2009,0,10117,Bob Heintz,187,123,64
2009,0,20572,Rod Pampling,187,90,97
2009,0,20229,Stewart Cink,188,39,149
2009,0,1948,Tim Petrovic,188,133,55
2009,0,20848,Ángel Cabrera,189,8,181
2009,0,19846,Brian Gay,189,183,6
2009,0,1226,Fred Couples,190,24,166
2009,0,27649,Brandt Snedeker,190,169,21
2009,0,27141,J.B. Holmes,191,7,184
2009,0,29718,Anthony Kim,191,16,175
2009,0,25919,Brian Vranesh,191,89,102
2009,0,26497,Casey Wittenberg,191,109,82
2009,0,26300,Matt Jones,192,23,169
2009,0,1810,Phil Mickelson,192,13,179
2009,0,26679,Kevin Stadler,192,75,117
2009,0,6595,Kevin Sutherland,192,80,112
2009,0,24357,K.J. Choi,193,150,43
2009,0,8075,Jerry Kelly,193,114,79
2009,0,23108,Matt Kuchar,194,128,66
2009,0,23800,Bryce Molder,194,129,65
2009,0,8931,Glen Day,195,174,21
2009,0,27060,John Mallinger,195,164,31
2009,0,23638,Brendon de Jonge,196,75,121
2009,0,1473,Todd Hamilton,196,113,83
2009,0,1677,Tom Lehman,196,179,17
2009,0,24490,George McNeill,196,61,135
2009,0,24361,Pat Perez,196,87,109
2009,0,7867,Woody Austin,197,99,98
2009,0,1132,Mark Brooks,197,182,15
2009,0,20157,Retief Goosen,197,58,139
2009,0,27683,Leif Olson,198,30,168
2009,0,1928,Corey Pavin,198,184,14
2009,0,25562,Andres Romero,198,18,180
2009,0,21961,Charles Howell III,199,53,146
2009,0,22348,Nick O'Hern,199,170,29
2009,0,24663,Y.E. Yang,200,67,133
2009,0,20070,Matt Bettencourt,201,52,149
2009,0,23621,Rory Sabbatini,201,47,154
2009,0,6643,Paul Goydos,202,172,30
2009,0,23614,Rich Beem,203,114,89
2009,0,8845,Scott Sterling,203,109,94
2009,0,24846,Ricky Barnes,207,55,152
2009,0,24138,Ian Poulter,208,133,75
2009,0,26420,Richard Johnson,209,176,33
2009,0,6539,Rick Price,210,166,44
2009,0,6251,Chris DiMarco,211,157,54
2009,0,12782,Tim Herron,212,59,153
2009,0,22046,Geoff Ogilvy,214,63,151
2009,0,12652,Cameron Beckman,215,97,118
2009,0,20634,Peter Lonard,215,157,58
2009,0,28475,Jeff Overton,215,41,174
2009,0,1797,Rocco Mediate,217,129,88
2009,0,20593,Greg Chalmers,218,119,99
2009,0,26668,Marc Turnesa,218,157,61
2009,0,20098,Stuart Appleby,219,77,142
2009,0,26881,Jarrod Lyle,219,95,124
2009,0,25190,Jeff Quinney,219,177,42
2009,0,12705,Cliff Kresge,221,149,72
2009,0,21949,Joe Ogilvie,223,65,158
2009,0,7457,Steve Flesch,225,117,108
2009,0,1941,Tom Pernice Jr.,226,140,86
2009,0,1161,Mark Calcavecchia,234,104,130
2009,0,9011,David Duval,236,53,183
2009,0,7749,Brett Quigley,237,93,144
2009,0,22621,Ben Curtis,238,157,81
2009,0,25396,Kevin Na,240,136,104
2009,0,23778,Brad Adamonis,242,82,160
2009,0,20104,Ken Duke,242,129,113
2009,0,29221,Webb Simpson,242,102,140
2009,0,25345,Carl Pettersson,243,86,157
2009,0,25632,Jimmy Walker,246,70,176
2009,0,7223,Brian Bateman,248,84,164
2009,0,28620,Aron Price,250,154,96
2009,0,1577,Lee Janzen,254,139,115
2009,0,22371,Aaron Baddeley,255,92,163
2009,0,23718,Nathan Green,255,123,132
2009,0,31416,Derek Fathauer,262,100,162
2009,0,22961,David Mathis,264,148,116
2009,0,12602,Dean Wilson,266,181,85
2009,0,21731,Freddie Jacobson,269,122,147
2009,0,10423,Mike Weir,269,163,106
2009,0,20766,Padraig Harrington,277,106,171
2009,0,6012,Greg Kraft,279,178,101
2009,0,27466,Spencer Levin,284,165,119
2009,0,23983,Luke Donald,287,173,114
2009,0,21350,Ryuji Imada,290,168,122
2009,0,30927,Brendon Todd,291,171,120
2009,0,23048,Eric Axley,315,133,182
2009,0,1329,Brad Faxon,324,180,144
2009,0,24449,Parker McLachlin,330,157,173
2008,0,22892,Jason Gore,56,15,41
2008,0,23349,Charles Warren,85,10,75
2008,0,28780,Nicholas Thompson,88,36,52
2008,0,27933,John Merrick,100,20,80
2008,0,2002,John Riegger,105,74,31
2008,0,12716,Charley Hoffman,107,12,95
2008,0,6621,Joe Durant,110,102,8
2008,0,20105,Jeff Gove,114,103,11
2008,0,20645,John Senden,116,81,35
2008,0,20574,Mathew Goggin,118,34,84
2008,0,22913,John Rollins,118,80,38
2008,0,26596,Ryan Moore,122,56,66
2008,0,6197,Michael Allen,126,101,25
2008,0,19803,Ryan Armour,126,103,23
2008,0,25364,Paul Casey,127,18,109
2008,0,23541,Ben Crane,128,86,42
2008,0,10875,Todd Demsey,130,53,77
2008,0,1553,John Huston,130,65,65
2008,0,10885,Robert Allenby,131,61,70
2008,0,23353,J.J. Henry,132,61,71
2008,0,27095,Nick Watney,135,7,128
2008,0,23614,Rich Beem,136,88,48
2008,0,24781,Hunter Mahan,137,75,62
2008,0,20378,Mathias Grönberg,140,38,102
2008,0,28158,Steve Marino,140,49,91
2008,0,20160,Charlie Wi,140,95,45
2008,0,24361,Pat Perez,141,44,97
2008,0,1766,Billy Mayfair,142,129,13
2008,0,21878,Mark Wilson,142,122,20
2008,0,12510,Chad Campbell,143,75,68
2008,0,23320,Ryan Palmer,144,44,100
2008,0,23788,D.J. Trahan,144,66,78
2008,0,27936,Martin Laird,145,31,114
2008,0,26289,Boo Weekley,146,61,85
2008,0,10425,Jay Williamson,147,123,24
2008,0,25900,Lucas Glover,148,23,125
2008,0,20572,Rod Pampling,151,82,69
2008,0,1945,Kenny Perry,153,33,120
2008,0,27963,Chris Stroud,153,95,58
2008,0,21805,Harrison Frazar,154,14,140
2008,0,21461,Kenneth Ferrie,155,119,36
2008,0,10733,Kent Jones,157,141,16
2008,0,26695,Michael Letzig,157,69,88
2008,0,24925,Jonathan Byrd,160,114,46
2008,0,1388,Robert Gamez,160,153,7
2008,0,1724,Jeff Maggert,160,110,50
2008,0,26476,Chez Reavie,161,152,9
2008,0,27561,Nick Flanagan,164,60,104
2008,0,27120,Troy Matteson,165,38,127
2008,0,21633,Steve Allan,166,5,161
2008,0,28089,Jason Day,166,27,139
2008,0,22293,Heath Slocum,167,164,3
2008,0,22621,Ben Curtis,168,121,47
2008,0,10585,Scott McCarron,169,139,30
2008,0,21949,Joe Ogilvie,169,88,81
2008,0,27214,Kevin Streelman,169,54,115
2008,0,1142,Bart Bryant,170,166,4
2008,0,1313,Steve Elkington,170,148,22
2008,0,29718,Anthony Kim,170,11,159
2008,0,24924,Bill Haas,171,29,142
2008,0,1706,Davis Love III,171,9,162
2008,0,30750,Tommy Gainey,172,24,148
2008,0,22378,Trevor Immelman,173,66,107
2008,0,7867,Woody Austin,174,114,60
2008,0,23497,Tag Ridings,174,6,168
2008,0,23623,Bo Van Pelt,174,58,116
2008,0,6567,Vijay Singh,175,25,150
2008,0,23621,Rory Sabbatini,176,58,118
2008,0,2239,Scott Verplank,176,170,6
2008,0,20498,Briny Baird,177,116,61
2008,0,1473,Todd Hamilton,180,129,51
2008,0,24358,Robert Garrigus,181,2,179
2008,0,22548,Patrick Sheehan,181,125,56
2008,0,10649,Tom Scherrer,182,88,94
2008,0,1035,Tommy Armour III,183,88,95
2008,0,21753,Brian Davis,183,173,10
2008,0,12782,Tim Herron,183,52,131
2008,0,1948,Tim Petrovic,183,129,54
2008,0,21959,Ted Purdy,184,54,130
2008,0,25804,Bubba Watson,184,1,183
2008,0,1226,Fred Couples,185,16,169
2008,0,26679,Kevin Stadler,185,68,117
2008,0,8385,Omar Uresti,185,183,2
2008,0,20766,Padraig Harrington,186,32,154
2008,0,24024,Zach Johnson,186,181,5
2008,0,8845,Scott Sterling,188,125,63
2008,0,10809,Jim Furyk,190,162,28
2008,0,22806,Doug LaBelle II,190,153,37
2008,0,24227,Justin Bolli,191,125,66
2008,0,19913,Ron Whittaker,191,177,14
2008,0,12652,Cameron Beckman,192,150,42
2008,0,24490,George McNeill,192,40,152
2008,0,6595,Kevin Sutherland,192,71,121
2008,0,23325,Vaughn Taylor,192,82,110
2008,0,24502,Adam Scott,193,8,185
2008,0,24663,Y.E. Yang,193,100,93
2008,0,1139,Olin Browne,195,194,1
2008,0,30925,Dustin Johnson,195,4,191
2008,0,27060,John Mallinger,195,169,26
2008,0,22348,Nick O'Hern,195,183,12
2008,0,26668,Marc Turnesa,195,117,78
2008,0,21209,Sergio Garcia,196,43,153
2008,0,10860,Justin Leonard,196,156,40
2008,0,25396,Kevin Na,197,158,39
2008,0,12826,Paul Claxton,198,180,18
2008,0,27141,J.B. Holmes,198,3,195
2008,0,6573,Brandt Jobe,198,21,177
2008,0,1320,Bob Estes,201,145,56
2008,0,23125,Brad Elder,202,78,124
2008,0,23540,Jason Allred,206,22,184
2008,0,25594,Travis Perkins,206,16,190
2008,0,11032,Frank Lickliter II,207,125,82
2008,0,24140,Sean O'Hair,207,69,138
2008,0,10505,Shane Bertsch,208,187,21
2008,0,26500,Alejandro Cañizares,208,97,111
2008,0,20848,Ángel Cabrera,209,13,196
2008,0,20229,Stewart Cink,209,28,181
2008,0,6643,Paul Goydos,209,190,19
2008,0,25842,Jon Mills,209,51,158
2008,0,20623,Gavin Coles,210,195,15
2008,0,20663,Brenden Pappas,211,42,169
2008,0,25562,Andres Romero,211,19,192
2008,0,2223,Bob Tway,211,167,44
2008,0,1161,Mark Calcavecchia,213,139,74
2008,0,19846,Brian Gay,213,196,17
2008,0,24912,Will MacKenzie,213,108,105
2008,0,28475,Jeff Overton,213,26,187
2008,0,8931,Glen Day,215,183,32
2008,0,27613,David Lutterus,216,84,132
2008,0,1810,Phil Mickelson,216,35,181
2008,0,7749,Brett Quigley,216,94,122
2008,0,27770,Camilo Villegas,216,50,166
2008,0,23157,Richard Johnson,217,29,188
2008,0,20634,Peter Lonard,217,153,64
2008,0,20472,Alex Cejka,218,142,76
2008,0,2206,David Toms,218,146,72
2008,0,25349,Tim Wilkinson,218,165,53
2008,0,7547,Craig Kanada,219,192,27
2008,0,20443,Jin Park,219,186,33
2008,0,12309,Bob Sowards,219,84,135
2008,0,22582,Kyle Thompson,219,111,108
2008,0,8537,J.P. Hayes,222,124,98
2008,0,22046,Geoff Ogilvy,222,57,165
2008,0,22371,Aaron Baddeley,223,73,150
2008,0,21961,Charles Howell III,223,48,175
2008,0,6012,Greg Kraft,223,189,34
2008,0,20127,Chris Riley,223,168,55
2008,0,10423,Mike Weir,225,119,106
2008,0,1928,Corey Pavin,226,197,29
2008,0,23409,James Driscoll,229,40,189
2008,0,12660,Jesper Parnevik,229,93,136
2008,0,25632,Jimmy Walker,229,36,193
2008,0,20104,Ken Duke,230,118,112
2008,0,24357,K.J. Choi,232,106,126
2008,0,1577,Lee Janzen,233,132,101
2008,0,26300,Matt Jones,233,47,186
2008,0,26420,Richard Johnson,235,146,89
2008,0,8075,Jerry Kelly,235,176,59
2008,0,1677,Tom Lehman,235,148,87
2008,0,6004,Stephen Ames,236,133,103
2008,0,20098,Stuart Appleby,236,72,164
2008,0,6522,Ernie Els,237,64,173
2008,0,20850,Daniel Chopra,238,44,194
2008,0,20433,Mark Hensby,239,79,160
2008,0,23135,Tim Clark,240,157,83
2008,0,20382,Stephen Leaney,240,191,49
2008,0,23778,Brad Adamonis,242,75,167
2008,0,1707,Steve Lowery,243,99,144
2008,0,6034,Marco Dawson,247,106,141
2008,0,1941,Tom Pernice Jr.,251,161,90
2008,0,25345,Carl Pettersson,253,108,145
2008,0,23108,Matt Kuchar,255,182,73
2008,0,6090,Jim McGovern,255,163,92
2008,0,1797,Rocco Mediate,256,170,86
2008,0,26631,Cody Freeman,257,86,171
2008,0,24449,Parker McLachlin,262,105,157
2008,0,23048,Eric Axley,264,88,176
2008,0,20157,Retief Goosen,271,97,174
2008,0,12705,Cliff Kresge,271,158,113
2008,0,26951,Johnson Wagner,271,138,133
2008,0,6251,Chris DiMarco,274,175,99
2008,0,12823,Carlos Franco,275,112,163
2008,0,24138,Ian Poulter,281,135,146
2008,0,23718,Nathan Green,283,134,149
2008,0,7457,Steve Flesch,284,150,134
2008,0,21731,Freddie Jacobson,284,142,142
2008,0,1024,Billy Andrade,292,137,155
2008,0,27649,Brandt Snedeker,297,160,137
2008,0,12602,Dean Wilson,301,178,123
2008,0,6575,Dudley Hart,308,179,129
2008,0,9011,David Duval,310,113,197
2008,0,25190,Jeff Quinney,312,193,119
2008,0,6527,Steve Stricker,313,135,178
2008,0,21350,Ryuji Imada,317,170,147
2008,0,23797,Brett Rumford,322,142,180
2008,0,25720,Chad Collins,330,174,156
2008,0,12680,Shigeki Maruyama,360,188,172
2007,0,23349,Charles Warren,59,9,50
2007,0,20574,Mathew Goggin,70,26,44
2007,0,24781,Hunter Mahan,73,36,37
2007,0,10425,Jay Williamson,84,72,12
2007,0,1945,Kenny Perry,104,22,82
2007,0,12652,Cameron Beckman,109,69,40
2007,0,22892,Jason Gore,110,8,102
2007,0,24140,Sean O'Hair,113,34,79
2007,0,20645,John Senden,115,55,60
2007,0,23788,D.J. Trahan,116,48,68
2007,0,26289,Boo Weekley,118,37,81
2007,0,24924,Bill Haas,120,11,109
2007,0,20498,Briny Baird,121,66,55
2007,0,28475,Jeff Overton,122,24,98
2007,0,27702,Matt Hendrix,129,15,114
2007,0,20472,Alex Cejka,130,94,36
2007,0,20691,Greg Owen,130,40,90
2007,0,20634,Peter Lonard,131,80,51
2007,0,8123,Jeff Brehaut,133,76,57
2007,0,25900,Lucas Glover,135,46,89
2007,0,1766,Billy Mayfair,135,117,18
2007,0,21470,Daisuke Maruyama,140,98,42
2007,0,27963,Chris Stroud,140,87,53
2007,0,21959,Ted Purdy,142,57,85
2007,0,10733,Kent Jones,143,111,32
2007,0,20104,Ken Duke,144,103,41
2007,0,6621,Joe Durant,144,139,5
2007,0,2036,Jim Rutledge,144,99,45
2007,0,6197,Michael Allen,146,61,85
2007,0,29718,Anthony Kim,146,12,134
2007,0,27095,Nick Watney,147,17,130
2007,0,20105,Jeff Gove,148,84,64
2007,0,23353,J.J. Henry,148,54,94
2007,0,26360,Bubba Dickerson,149,25,124
2007,0,1035,Tommy Armour III,150,126,24
2007,0,23614,Rich Beem,150,79,71
2007,0,10885,Robert Allenby,154,22,132
2007,0,21646,David Branshaw,155,93,62
2007,0,21633,Steve Allan,156,12,144
2007,0,19803,Ryan Armour,157,135,22
2007,0,27933,John Merrick,158,33,125
2007,0,1161,Mark Calcavecchia,159,86,73
2007,0,22913,John Rollins,162,85,77
2007,0,24457,Jaco Van Zyl,162,131,31
2007,0,8793,Tiger Woods,164,12,152
2007,0,28158,Steve Marino,165,29,136
2007,0,24361,Pat Perez,166,37,129
2007,0,22295,Darron Stiles,167,134,33
2007,0,23623,Bo Van Pelt,168,50,118
2007,0,1707,Steve Lowery,169,67,102
2007,0,27770,Camilo Villegas,169,27,142
2007,0,20378,Mathias Grönberg,170,16,154
2007,0,1157,Tom Byrum,171,156,15
2007,0,27141,J.B. Holmes,171,3,168
2007,0,10860,Justin Leonard,173,148,25
2007,0,10809,Jim Furyk,174,171,3
2007,0,26596,Ryan Moore,174,82,92
2007,0,19824,Craig Barlow,176,45,131
2007,0,25892,Steve Wheatcroft,176,122,54
2007,0,20160,Charlie Wi,176,124,52
2007,0,24024,Zach Johnson,177,169,8
2007,0,24490,George McNeill,177,28,149
2007,0,6515,Shaun Micheel,177,138,39
2007,0,23322,Brett Wetterich,177,7,170
2007,0,21878,Mark Wilson,177,131,46
2007,0,1313,Steve Elkington,178,164,14
2007,0,24502,Adam Scott,178,18,160
2007,0,22293,Heath Slocum,178,172,6
2007,0,1142,Bart Bryant,179,160,19
2007,0,23933,Michael Boyd,180,176,4
2007,0,2101,Joey Sindelar,180,111,69
2007,0,23497,Tag Ridings,181,6,175
2007,0,21660,Jason Schultz,181,43,138
2007,0,2246,Duffy Waldorf,181,107,74
2007,0,12714,Chris Tidland,182,62,120
2007,0,24507,Jason Bohn,183,111,72
2007,0,8931,Glen Day,184,164,20
2007,0,20127,Chris Riley,184,167,17
2007,0,21753,Brian Davis,185,172,13
2007,0,27120,Troy Matteson,185,37,148
2007,0,1388,Robert Gamez,186,159,27
2007,0,12195,Tom Johnson,186,103,83
2007,0,8375,Paul Stankowski,188,43,145
2007,0,2239,Scott Verplank,188,172,16
2007,0,10423,Mike Weir,188,92,96
2007,0,27060,John Mallinger,189,163,26
2007,0,25804,Bubba Watson,189,1,188
2007,0,24980,Scott Gutschewski,190,5,185
2007,0,24912,Will MacKenzie,191,74,117
2007,0,22405,Justin Rose,191,96,95
2007,0,19972,José Coceres,192,191,1
2007,0,22378,Trevor Immelman,193,118,75
2007,0,1381,Fred Funk,195,193,2
2007,0,8537,J.P. Hayes,195,69,126
2007,0,12716,Charley Hoffman,195,19,176
2007,0,8881,Tripp Isenhour,195,111,84
2007,0,8075,Jerry Kelly,196,162,34
2007,0,7363,Craig Bowden,197,190,7
2007,0,24358,Robert Garrigus,197,4,193
2007,0,26882,Michael Sim,197,78,119
2007,0,1249,John Daly,198,2,196
2007,0,22806,Doug LaBelle II,198,187,11
2007,0,26881,Jarrod Lyle,198,65,133
2007,0,1132,Mark Brooks,199,189,10
2007,0,21805,Harrison Frazar,199,9,190
2007,0,28486,Michael Putnam,200,53,147
2007,0,6004,Stephen Ames,201,154,47
2007,0,11123,Chris Couch,202,20,182
2007,0,29476,Kyle Reifers,202,41,161
2007,0,2214,Kirk Triplett,202,181,21
2007,0,19846,Brian Gay,203,194,9
2007,0,1706,Davis Love III,203,34,169
2007,0,26679,Kevin Stadler,203,62,141
2007,0,1724,Jeff Maggert,205,142,63
2007,0,1941,Tom Pernice Jr.,205,156,49
2007,0,23135,Tim Clark,206,178,28
2007,0,7457,Steve Flesch,207,107,100
2007,0,11032,Frank Lickliter II,207,142,65
2007,0,24290,D.J. Brigman,210,94,116
2007,0,6522,Ernie Els,210,31,179
2007,0,1810,Phil Mickelson,210,29,181
2007,0,10117,Bob Heintz,211,133,78
2007,0,23983,Luke Donald,212,177,35
2007,0,20859,Anders Hansen,212,164,48
2007,0,22046,Geoff Ogilvy,212,47,165
2007,0,6595,Kevin Sutherland,212,75,137
2007,0,25190,Jeff Quinney,213,155,58
2007,0,6567,Vijay Singh,213,58,155
2007,0,12660,Jesper Parnevik,214,99,115
2007,0,22371,Aaron Baddeley,215,69,146
2007,0,21961,Charles Howell III,215,20,195
2007,0,24925,Jonathan Byrd,216,67,149
2007,0,20433,Mark Hensby,216,115,101
2007,0,1797,Rocco Mediate,216,178,38
2007,0,23638,Brendon de Jonge,217,58,159
2007,0,26951,Johnson Wagner,217,129,88
2007,0,20623,Gavin Coles,218,195,23
2007,0,21949,Joe Ogilvie,218,91,127
2007,0,1320,Bob Estes,219,149,70
2007,0,20098,Stuart Appleby,220,80,140
2007,0,25273,Andrew Buckle,221,50,171
2007,0,20850,Daniel Chopra,221,32,189
2007,0,6643,Paul Goydos,221,192,29
2007,0,20572,Rod Pampling,221,119,102
2007,0,21528,Henrik Stenson,221,41,180
2007,0,25396,Kevin Na,222,109,113
2007,0,23320,Ryan Palmer,222,49,173
2007,0,24357,K.J. Choi,223,144,79
2007,0,12510,Chad Campbell,225,115,110
2007,0,25686,Jason Dufner,225,90,135
2007,0,26420,Richard Johnson,226,160,66
2007,0,1928,Corey Pavin,226,196,30
2007,0,2206,David Toms,226,151,75
2007,0,7867,Woody Austin,227,122,105
2007,0,22621,Ben Curtis,228,185,43
2007,0,1677,Tom Lehman,228,137,91
2007,0,12782,Tim Herron,232,110,122
2007,0,20229,Stewart Cink,233,50,183
2007,0,20766,Padraig Harrington,234,60,174
2007,0,21731,Freddie Jacobson,234,135,99
2007,0,23325,Vaughn Taylor,234,147,87
2007,0,21806,Paul Gow,237,170,67
2007,0,6034,Marco Dawson,238,89,149
2007,0,7223,Brian Bateman,239,72,167
2007,0,21209,Sergio Garcia,239,55,184
2007,0,23108,Matt Kuchar,241,185,56
2007,0,7547,Craig Kanada,242,183,59
2007,0,20382,Stephen Leaney,243,182,61
2007,0,6527,Steve Stricker,243,146,97
2007,0,23621,Rory Sabbatini,250,88,162
2007,0,22212,Craig Lile,251,145,106
2007,0,20628,Arron Oberholser,252,129,123
2007,0,20157,Retief Goosen,254,62,192
2007,0,12705,Cliff Kresge,255,127,128
2007,0,25345,Carl Pettersson,256,99,157
2007,0,24138,Ian Poulter,258,151,107
2007,0,23718,Nathan Green,259,139,120
2007,0,1948,Tim Petrovic,262,119,143
2007,0,23800,Bryce Molder,267,76,191
2007,0,1577,Lee Janzen,268,105,163
2007,0,10213,Dicky Pride,268,156,112
2007,0,7749,Brett Quigley,268,82,186
2007,0,1473,Todd Hamilton,273,96,177
2007,0,12602,Dean Wilson,275,183,92
2007,0,1024,Billy Andrade,277,121,156
2007,0,24449,Parker McLachlin,277,99,178
2007,0,2223,Bob Tway,278,139,139
2007,0,27649,Brandt Snedeker,280,127,153
2007,0,22348,Nick O'Hern,286,175,111
2007,0,12680,Shigeki Maruyama,288,180,108
2007,0,23048,Eric Axley,293,106,187
2007,0,23613,Rich Barcelo,296,124,172
2007,0,21350,Ryuji Imada,315,149,166
2007,0,6251,Chris DiMarco,317,153,164
2007,0,2104,Jeff Sluman,325,168,157
2007,0,6373,José María Olazábal,382,188,194
2006,0,24980,Scott Gutschewski,83,11,72
2006,0,2106,Chris Smith,84,24,60
2006,0,28780,Nicholas Thompson,89,48,41
2006,0,24781,Hunter Mahan,91,57,34
2006,0,10885,Robert Allenby,93,64,29
2006,0,6621,Joe Durant,94,93,1
2006,0,20691,Greg Owen,101,54,47
2006,0,1945,Kenny Perry,102,69,33
2006,0,23349,Charles Warren,104,20,84
2006,0,25900,Lucas Glover,114,23,91
2006,0,24925,Jonathan Byrd,115,33,82
2006,0,20645,John Senden,117,44,73
2006,0,20766,Padraig Harrington,119,60,59
2006,0,24138,Ian Poulter,120,100,20
2006,0,26596,Ryan Moore,124,74,50
2006,0,23322,Brett Wetterich,126,4,122
2006,0,20094,Jonathan Kaye,128,61,67
2006,0,22913,John Rollins,129,50,79
2006,0,26360,Bubba Dickerson,132,27,105
2006,0,24502,Adam Scott,133,16,117
2006,0,1313,Steve Elkington,134,127,7
2006,0,21646,David Branshaw,137,102,35
2006,0,21753,Brian Davis,137,115,22
2006,0,27095,Nick Watney,139,18,121
2006,0,20574,Mathew Goggin,140,45,95
2006,0,24912,Will MacKenzie,143,40,103
2006,0,6595,Kevin Sutherland,143,67,76
2006,0,21805,Harrison Frazar,145,9,136
2006,0,8793,Tiger Woods,145,6,139
2006,0,23614,Rich Beem,146,48,98
2006,0,22946,Henrik Bjornstad,146,39,107
2006,0,10733,Kent Jones,147,110,37
2006,0,24507,Jason Bohn,148,95,53
2006,0,20498,Briny Baird,151,135,16
2006,0,20105,Jeff Gove,152,88,64
2006,0,23048,Eric Axley,153,61,92
2006,0,20472,Alex Cejka,153,96,57
2006,0,2246,Duffy Waldorf,153,115,38
2006,0,21470,Daisuke Maruyama,154,139,15
2006,0,11123,Chris Couch,155,21,134
2006,0,20127,Chris Riley,157,139,18
2006,0,1706,Davis Love III,158,14,144
2006,0,8537,J.P. Hayes,159,108,51
2006,0,12645,Brent Geiberger,161,113,48
2006,0,24140,Sean O'Hair,161,71,90
2006,0,21959,Ted Purdy,162,101,61
2006,0,23320,Ryan Palmer,163,47,116
2006,0,2206,David Toms,163,133,30
2006,0,20378,Mathias Grönberg,164,54,110
2006,0,27943,Matt Hansen,164,19,145
2006,0,22892,Jason Gore,165,22,143
2006,0,6573,Brandt Jobe,165,37,128
2006,0,1142,Bart Bryant,167,156,11
2006,0,10809,Jim Furyk,167,159,8
2006,0,23788,D.J. Trahan,167,81,86
2006,0,22293,Heath Slocum,169,165,4
2006,0,24024,Zach Johnson,171,145,26
2006,0,22405,Justin Rose,171,82,89
2006,0,22046,Geoff Ogilvy,172,53,119
2006,0,22378,Trevor Immelman,173,58,115
2006,0,23623,Bo Van Pelt,173,35,138
2006,0,20812,Tjaart van der Walt,174,150,24
2006,0,1766,Billy Mayfair,175,154,21
2006,0,22548,Patrick Sheehan,176,105,71
2006,0,8375,Paul Stankowski,176,51,125
2006,0,12716,Charley Hoffman,177,10,167
2006,0,1810,Phil Mickelson,177,17,160
2006,0,8385,Omar Uresti,177,171,6
2006,0,1619,Skip Kendall,178,165,13
2006,0,1724,Jeff Maggert,178,164,14
2006,0,27770,Camilo Villegas,178,13,165
2006,0,27120,Troy Matteson,179,28,151
2006,0,2214,Kirk Triplett,179,168,11
2006,0,24358,Robert Garrigus,180,3,177
2006,0,11032,Frank Lickliter II,180,125,55
2006,0,24357,K.J. Choi,182,112,70
2006,0,8123,Jeff Brehaut,183,125,58
2006,0,1823,Larry Mize,183,178,5
2006,0,6527,Steve Stricker,183,134,49
2006,0,8835,Kris Cox,184,30,154
2006,0,26420,Richard Johnson,184,148,36
2006,0,20631,David McKenzie,184,142,42
2006,0,24361,Pat Perez,184,30,154
2006,0,7223,Brian Bateman,186,40,146
2006,0,28475,Jeff Overton,187,26,161
2006,0,23353,J.J. Henry,188,46,142
2006,0,6004,Stephen Ames,189,88,101
2006,0,7457,Steve Flesch,189,124,65
2006,0,27141,J.B. Holmes,189,2,187
2006,0,6350,Bob May,189,71,118
2006,0,2239,Scott Verplank,189,186,3
2006,0,21949,Joe Ogilvie,192,107,85
2006,0,25804,Bubba Watson,192,1,191
2006,0,1139,Olin Browne,193,184,9
2006,0,19913,Ron Whittaker,193,161,32
2006,0,1249,John Daly,195,5,190
2006,0,21731,Freddie Jacobson,195,84,111
2006,0,1381,Fred Funk,196,194,2
2006,0,23497,Tag Ridings,196,8,188
2006,0,23983,Luke Donald,197,145,52
2006,0,8075,Jerry Kelly,198,179,19
2006,0,23307,Roger Tambellini,198,24,174
2006,0,1219,John Cook,199,182,17
2006,0,10860,Justin Leonard,199,154,45
2006,0,21407,Arjun Atwal,200,102,98
2006,0,21209,Sergio Garcia,200,71,129
2006,0,12662,Thomas Levet,200,113,87
2006,0,1226,Fred Couples,201,15,186
2006,0,1388,Robert Gamez,201,174,27
2006,0,23616,Ryan Hietala,201,7,194
2006,0,11011,Mike Sposa,201,138,63
2006,0,6643,Paul Goydos,202,192,10
2006,0,6034,Marco Dawson,203,77,126
2006,0,21878,Mark Wilson,203,157,46
2006,0,25936,Alex Aragon,204,12,192
2006,0,2110,Jerry Smith,205,180,25
2006,0,1035,Tommy Armour III,206,152,54
2006,0,12760,Danny Ellis,206,66,140
2006,0,20608,David Howell,206,93,113
2006,0,25240,D.A. Points,206,92,114
2006,0,1320,Bob Estes,207,120,87
2006,0,20850,Daniel Chopra,208,29,179
2006,0,10565,Ian Leggatt,208,77,131
2006,0,12660,Jesper Parnevik,209,86,123
2006,0,2101,Joey Sindelar,209,143,66
2006,0,20157,Retief Goosen,210,34,176
2006,0,24924,Bill Haas,210,40,170
2006,0,6012,Greg Kraft,210,187,23
2006,0,25842,Jon Mills,210,32,178
2006,0,23325,Vaughn Taylor,212,115,97
2006,0,1941,Tom Pernice Jr.,213,144,69
2006,0,6515,Shaun Micheel,217,97,120
2006,0,6567,Vijay Singh,218,65,153
2006,0,10505,Shane Bertsch,219,176,43
2006,0,1707,Steve Lowery,219,110,109
2006,0,1132,Mark Brooks,220,192,28
2006,0,1161,Mark Calcavecchia,220,152,68
2006,0,19846,Brian Gay,220,189,31
2006,0,12782,Tim Herron,220,59,161
2006,0,23541,Ben Crane,221,127,94
2006,0,21660,Jason Schultz,221,69,152
2006,0,20229,Stewart Cink,223,75,148
2006,0,6522,Ernie Els,225,54,171
2006,0,23135,Tim Clark,227,183,44
2006,0,20099,Doug Barron,228,188,40
2006,0,9011,David Duval,228,35,193
2006,0,19824,Craig Barlow,229,63,166
2006,0,12510,Chad Campbell,230,83,147
2006,0,7867,Woody Austin,231,102,129
2006,0,1042,Paul Azinger,233,127,106
2006,0,22621,Ben Curtis,233,177,56
2006,0,21961,Charles Howell III,233,51,182
2006,0,1553,John Huston,233,75,158
2006,0,25632,Jimmy Walker,234,38,196
2006,0,22371,Aaron Baddeley,235,98,137
2006,0,1928,Corey Pavin,235,196,39
2006,0,1024,Billy Andrade,236,132,104
2006,0,23409,James Driscoll,238,43,195
2006,0,1666,Bernhard Langer,239,127,112
2006,0,20098,Stuart Appleby,240,90,150
2006,0,20572,Rod Pampling,240,99,141
2006,0,20628,Arron Oberholser,244,136,108
2006,0,12680,Shigeki Maruyama,245,122,123
2006,0,12602,Dean Wilson,245,149,96
2006,0,6197,Michael Allen,246,79,167
2006,0,20382,Stephen Leaney,247,185,62
2006,0,25345,Carl Pettersson,247,115,132
2006,0,2104,Jeff Sluman,247,172,75
2006,0,7749,Brett Quigley,248,91,157
2006,0,10423,Mike Weir,248,165,83
2006,0,7013,Wes Short Jr.,249,80,169
2006,0,1677,Tom Lehman,250,115,135
2006,0,20634,Peter Lonard,251,170,81
2006,0,6251,Chris DiMarco,253,175,78
2006,0,12823,Carlos Franco,253,68,185
2006,0,1685,J.L. Lewis,253,173,80
2006,0,23718,Nathan Green,257,157,100
2006,0,6373,José María Olazábal,257,108,149
2006,0,1599,Steve Jones,258,181,77
2006,0,1948,Tim Petrovic,261,168,93
2006,0,19881,Robert Damron,264,162,102
2006,0,20121,Todd Fischer,264,190,74
2006,0,1761,Len Mattiace,265,85,180
2006,0,2223,Bob Tway,266,139,127
2006,0,23621,Rory Sabbatini,268,87,181
2006,0,25935,John Engler Jr.,270,106,164
2006,0,6575,Dudley Hart,285,122,163
2006,0,23673,Michael Connell,292,159,133
2006,0,21350,Ryuji Imada,296,137,159
2006,0,12755,Vance Veazey,299,127,172
2006,0,20593,Greg Chalmers,309,120,189
2006,0,20548,Hidemichi Tanaka,318,162,156
2006,0,1473,Todd Hamilton,331,147,184
2006,0,1577,Lee Janzen,332,150,182
2006,0,1887,Mark O'Meara,366,191,175
2006,0,1329,Brad Faxon,368,195,173
2005,0,26758,David Hearn,72,45,27
2005,0,1945,Kenny Perry,98,9,89
2005,0,21805,Harrison Frazar,104,17,87
2005,0,6621,Joe Durant,105,92,13
2005,0,23349,Charles Warren,106,27,79
2005,0,20378,Mathias Grönberg,108,15,93
2005,0,10962,Bradley Hughes,113,75,38
2005,0,21951,Joey Snyder III,118,68,50
2005,0,1766,Billy Mayfair,125,103,22
2005,0,20645,John Senden,131,77,54
2005,0,24912,Will MacKenzie,132,20,112
2005,0,24024,Zach Johnson,133,86,47
2005,0,20502,Michael Long,133,29,104
2005,0,22913,John Rollins,133,49,84
2005,0,8123,Jeff Brehaut,134,114,20
2005,0,24290,D.J. Brigman,136,42,94
2005,0,21959,Ted Purdy,136,45,91
2005,0,22405,Justin Rose,136,51,85
2005,0,26287,Roland Thatcher,137,67,70
2005,0,1161,Mark Calcavecchia,140,91,49
2005,0,10885,Robert Allenby,142,33,109
2005,0,20498,Briny Baird,143,100,43
2005,0,2101,Joey Sindelar,144,113,31
2005,0,26420,Richard Johnson,145,117,28
2005,0,20094,Jonathan Kaye,145,80,65
2005,0,24140,Sean O'Hair,150,23,127
2005,0,25900,Lucas Glover,151,12,139
2005,0,1685,J.L. Lewis,151,71,80
2005,0,1724,Jeff Maggert,151,135,16
2005,0,1142,Bart Bryant,153,147,6
2005,0,20472,Alex Cejka,153,114,39
2005,0,23623,Bo Van Pelt,157,59,98
2005,0,19824,Craig Barlow,159,88,71
2005,0,23788,D.J. Trahan,159,41,118
2005,0,1553,John Huston,161,56,105
2005,0,23325,Vaughn Taylor,162,84,78
2005,0,2206,David Toms,162,107,55
2005,0,21753,Brian Davis,163,155,8
2005,0,6034,Marco Dawson,163,63,100
2005,0,21209,Sergio Garcia,163,10,153
2005,0,10733,Kent Jones,163,102,61
2005,0,6567,Vijay Singh,164,16,148
2005,0,20396,Lee Westwood,164,38,126
2005,0,1035,Tommy Armour III,165,112,53
2005,0,24357,K.J. Choi,165,98,67
2005,0,12826,Paul Claxton,165,153,12
2005,0,23353,J.J. Henry,165,34,131
2005,0,2106,Chris Smith,165,18,147
2005,0,22295,Darron Stiles,165,142,23
2005,0,1797,Rocco Mediate,168,108,60
2005,0,25240,D.A. Points,168,82,86
2005,0,26679,Kevin Stadler,168,23,145
2005,0,2239,Scott Verplank,168,159,9
2005,0,24980,Scott Gutschewski,169,4,165
2005,0,10425,Jay Williamson,169,155,14
2005,0,22046,Geoff Ogilvy,170,31,139
2005,0,22293,Heath Slocum,170,159,11
2005,0,2246,Duffy Waldorf,172,149,23
2005,0,20098,Stuart Appleby,174,19,155
2005,0,1706,Davis Love III,174,8,166
2005,0,24507,Jason Bohn,175,62,113
2005,0,12510,Chad Campbell,176,52,124
2005,0,6595,Kevin Sutherland,176,108,68
2005,0,1139,Olin Browne,177,173,4
2005,0,1941,Tom Pernice Jr.,179,80,99
2005,0,20548,Hidemichi Tanaka,179,150,29
2005,0,21407,Arjun Atwal,180,50,130
2005,0,27095,Nick Watney,182,28,154
2005,0,12652,Cameron Beckman,183,120,63
2005,0,1707,Steve Lowery,183,77,106
2005,0,24781,Hunter Mahan,183,55,128
2005,0,20433,Mark Hensby,185,83,102
2005,0,23322,Brett Wetterich,185,3,182
2005,0,20572,Rod Pampling,186,40,146
2005,0,12454,Mario Tiziani,186,122,64
2005,0,7223,Brian Bateman,187,76,111
2005,0,12782,Tim Herron,187,65,122
2005,0,1810,Phil Mickelson,187,26,161
2005,0,20691,Greg Owen,187,71,116
2005,0,24925,Jonathan Byrd,188,37,151
2005,0,8075,Jerry Kelly,188,155,33
2005,0,6573,Brandt Jobe,189,11,178
2005,0,20812,Tjaart van der Walt,190,140,50
2005,0,19972,José Coceres,191,184,7
2005,0,19881,Robert Damron,191,181,10
2005,0,20628,Arron Oberholser,193,145,48
2005,0,8793,Tiger Woods,193,2,191
2005,0,21633,Steve Allan,194,32,162
2005,0,8385,Omar Uresti,194,191,3
2005,0,23108,Matt Kuchar,195,170,25
2005,0,23320,Ryan Palmer,196,47,149
2005,0,2223,Bob Tway,196,114,82
2005,0,1677,Tom Lehman,197,121,76
2005,0,23135,Tim Clark,199,140,59
2005,0,1381,Fred Funk,199,197,2
2005,0,23725,Brendan Jones,199,14,185
2005,0,24502,Adam Scott,199,23,176
2005,0,20474,Phillip Price,200,142,58
2005,0,20099,Doug Barron,201,175,26
2005,0,1313,Steve Elkington,201,145,56
2005,0,20157,Retief Goosen,201,44,157
2005,0,10809,Jim Furyk,202,170,32
2005,0,1487,Jeff Hart,202,201,1
2005,0,1619,Skip Kendall,202,187,15
2005,0,10860,Justin Leonard,202,128,74
2005,0,23063,Scott Hend,203,1,202
2005,0,11032,Frank Lickliter II,204,103,101
2005,0,20663,Brenden Pappas,204,6,198
2005,0,2214,Kirk Triplett,204,187,17
2005,0,20623,Gavin Coles,205,200,5
2005,0,1249,John Daly,205,5,200
2005,0,8725,Tom Gillis,205,133,72
2005,0,24361,Pat Perez,205,68,137
2005,0,25345,Carl Pettersson,205,70,135
2005,0,23552,Hank Kuehne,206,7,199
2005,0,1388,Robert Gamez,208,162,46
2005,0,6599,John Elliott,209,13,196
2005,0,23497,Tag Ridings,209,20,189
2005,0,23983,Luke Donald,210,135,75
2005,0,1823,Larry Mize,211,192,19
2005,0,1157,Tom Byrum,213,195,18
2005,0,1226,Fred Couples,213,39,174
2005,0,20634,Peter Lonard,213,93,120
2005,0,1175,Jim Carter,215,185,30
2005,0,1361,Dan Forsman,215,52,163
2005,0,6515,Shaun Micheel,215,101,114
2005,0,21878,Mark Wilson,215,174,41
2005,0,1219,John Cook,217,196,21
2005,0,6332,Neal Lancaster,217,58,159
2005,0,20382,Stephen Leaney,217,182,35
2005,0,10585,Scott McCarron,218,77,141
2005,0,1927,Dennis Paulson,218,30,188
2005,0,2104,Jeff Sluman,218,176,42
2005,0,12602,Dean Wilson,218,152,66
2005,0,1320,Bob Estes,219,142,77
2005,0,12680,Shigeki Maruyama,219,98,121
2005,0,23540,Jason Allred,221,20,201
2005,0,1127,Danny Briggs,222,185,37
2005,0,20850,Daniel Chopra,222,35,187
2005,0,20127,Chris Riley,222,178,44
2005,0,23621,Rory Sabbatini,222,36,186
2005,0,12823,Carlos Franco,223,48,175
2005,0,1599,Steve Jones,224,167,57
2005,0,8931,Glen Day,225,118,107
2005,0,1473,Todd Hamilton,227,110,117
2005,0,21961,Charles Howell III,228,56,172
2005,0,21806,Paul Gow,230,178,52
2005,0,7749,Brett Quigley,230,59,171
2005,0,22548,Patrick Sheehan,230,96,134
2005,0,2010,Loren Roberts,231,197,34
2005,0,12660,Jesper Parnevik,232,64,168
2005,0,19846,Brian Gay,233,193,40
2005,0,28088,Matt Davidson,234,165,69
2005,0,1418,Bill Glasson,234,139,95
2005,0,21949,Joe Ogilvie,234,131,103
2005,0,7867,Woody Austin,235,93,142
2005,0,1132,Mark Brooks,235,199,36
2005,0,7457,Steve Flesch,235,138,97
2005,0,23409,James Driscoll,237,42,195
2005,0,24138,Ian Poulter,239,132,107
2005,0,10423,Mike Weir,240,158,82
2005,0,1024,Billy Andrade,241,151,90
2005,0,10117,Bob Heintz,241,71,170
2005,0,20766,Padraig Harrington,243,54,189
2005,0,23541,Ben Crane,244,61,183
2005,0,20160,Charlie Wi,244,129,115
2005,0,24604,Hunter Haas,247,88,159
2005,0,1928,Corey Pavin,247,202,45
2005,0,1457,Jay Haas,249,187,62
2005,0,6575,Dudley Hart,250,127,123
2005,0,24227,Justin Bolli,252,96,156
2005,0,21350,Ryuji Imada,252,85,167
2005,0,6004,Stephen Ames,254,122,132
2005,0,6197,Michael Allen,257,65,192
2005,0,23036,Chris Anderson,258,177,81
2005,0,22621,Ben Curtis,258,170,88
2005,0,12645,Brent Geiberger,258,162,96
2005,0,8545,Glen Hnatiuk,258,148,110
2005,0,20121,Todd Fischer,260,187,73
2005,0,10201,Matt Gogel,261,169,92
2005,0,6373,José María Olazábal,261,103,158
2005,0,1666,Bernhard Langer,262,93,169
2005,0,21498,Hideto Tanihara,264,135,129
2005,0,21731,Freddie Jacobson,266,90,176
2005,0,22371,Aaron Baddeley,268,74,194
2005,0,1723,Andrew Magee,268,87,181
2005,0,1042,Paul Azinger,269,133,136
2005,0,20229,Stewart Cink,269,126,143
2005,0,23614,Rich Beem,270,106,164
2005,0,25396,Kevin Na,285,167,118
2005,0,6251,Chris DiMarco,289,164,125
2005,0,12662,Thomas Levet,290,110,180
2005,0,8537,J.P. Hayes,297,153,144
2005,0,1948,Tim Petrovic,297,118,179
2005,0,1577,Lee Janzen,309,125,184
2005,0,10912,Craig Perks,315,122,193
2005,0,1887,Mark O'Meara,316,183,133
2005,0,25847,Rob Rashell,318,166,152
2005,0,6527,Steve Stricker,326,129,197
2005,0,1761,Len Mattiace,328,178,150
2005,0,1329,Brad Faxon,332,194,138
2005,0,8993,Franklin Langham,332,159,173
2004,0,8123,Jeff Brehaut,79,62,17
2004,0,20645,John Senden,94,23,71
2004,0,25900,Lucas Glover,99,6,93
2004,0,21959,Ted Purdy,99,76,23
2004,0,6621,Joe Durant,101,97,4
2004,0,23353,J.J. Henry,101,10,91
2004,0,24507,Jason Bohn,110,41,69
2004,0,19824,Craig Barlow,111,61,50
2004,0,7223,Brian Bateman,113,48,65
2004,0,23623,Bo Van Pelt,114,36,78
2004,0,10885,Robert Allenby,116,34,82
2004,0,21805,Harrison Frazar,117,18,99
2004,0,10425,Jay Williamson,118,85,33
2004,0,12652,Cameron Beckman,121,59,62
2004,0,22046,Geoff Ogilvy,121,7,114
2004,0,10585,Scott McCarron,123,39,84
2004,0,2101,Joey Sindelar,123,53,70
2004,0,23325,Vaughn Taylor,125,46,79
2004,0,1677,Tom Lehman,126,97,29
2004,0,8337,Mike Heinen,127,4,123
2004,0,24024,Zach Johnson,128,113,15
2004,0,26287,Roland Thatcher,129,43,86
2004,0,10733,Kent Jones,130,103,27
2004,0,24361,Pat Perez,134,54,80
2004,0,22913,John Rollins,137,101,36
2004,0,1766,Billy Mayfair,140,118,22
2004,0,20029,Notah Begay III,141,110,31
2004,0,23320,Ryan Palmer,142,29,113
2004,0,12645,Brent Geiberger,143,56,87
2004,0,1142,Bart Bryant,145,138,7
2004,0,1313,Steve Elkington,145,100,45
2004,0,1161,Mark Calcavecchia,148,56,92
2004,0,1139,Olin Browne,150,142,8
2004,0,1810,Phil Mickelson,151,30,121
2004,0,20094,Jonathan Kaye,152,62,90
2004,0,21878,Mark Wilson,152,138,14
2004,0,11032,Frank Lickliter II,154,94,60
2004,0,1945,Kenny Perry,154,26,128
2004,0,10201,Matt Gogel,155,113,42
2004,0,20498,Briny Baird,156,73,83
2004,0,1685,J.L. Lewis,156,83,73
2004,0,1797,Rocco Mediate,156,131,25
2004,0,1941,Tom Pernice Jr.,156,109,47
2004,0,2246,Duffy Waldorf,156,116,40
2004,0,20628,Arron Oberholser,159,122,37
2004,0,23614,Rich Beem,160,22,138
2004,0,2106,Chris Smith,161,5,156
2004,0,6595,Kevin Sutherland,161,105,56
2004,0,20548,Hidemichi Tanaka,161,150,11
2004,0,24925,Jonathan Byrd,162,28,134
2004,0,1388,Robert Gamez,162,85,77
2004,0,1927,Dennis Paulson,163,14,149
2004,0,6567,Vijay Singh,163,13,150
2004,0,20157,Retief Goosen,164,38,126
2004,0,21893,Brian Kortan,164,47,117
2004,0,26420,Richard Johnson,165,131,34
2004,0,1706,Davis Love III,165,14,151
2004,0,20098,Stuart Appleby,167,42,125
2004,0,7867,Woody Austin,168,56,112
2004,0,24290,D.J. Brigman,169,65,104
2004,0,21633,Steve Allan,170,11,159
2004,0,6004,Stephen Ames,170,89,81
2004,0,21646,David Branshaw,170,110,60
2004,0,1553,John Huston,170,103,67
2004,0,19972,José Coceres,172,166,6
2004,0,20433,Mark Hensby,173,122,51
2004,0,22293,Heath Slocum,175,157,18
2004,0,2239,Scott Verplank,175,173,2
2004,0,24781,Hunter Mahan,176,45,131
2004,0,21961,Charles Howell III,177,82,95
2004,0,8835,Kris Cox,178,16,162
2004,0,8931,Glen Day,179,107,72
2004,0,2214,Kirk Triplett,179,167,12
2004,0,23135,Tim Clark,181,168,13
2004,0,23307,Roger Tambellini,181,21,160
2004,0,1724,Jeff Maggert,183,148,35
2004,0,12682,Hirofumi Miyase,183,163,20
2004,0,10107,Deane Pappas,184,32,152
2004,0,20580,Andre Stolz,185,20,165
2004,0,10860,Justin Leonard,187,134,53
2004,0,2099,Scott Simpson,188,169,19
2004,0,12510,Chad Campbell,189,87,102
2004,0,11123,Chris Couch,189,8,181
2004,0,23108,Matt Kuchar,189,94,95
2004,0,23063,Scott Hend,191,2,189
2004,0,1619,Skip Kendall,191,146,45
2004,0,22548,Patrick Sheehan,191,72,119
2004,0,8793,Tiger Woods,191,9,182
2004,0,23983,Luke Donald,192,162,30
2004,0,25686,Jason Dufner,192,65,127
2004,0,1527,Scott Hoch,192,154,38
2004,0,23497,Tag Ridings,192,12,180
2004,0,1381,Fred Funk,193,192,1
2004,0,8075,Jerry Kelly,193,172,21
2004,0,1157,Tom Byrum,195,190,5
2004,0,20850,Daniel Chopra,195,26,169
2004,0,1249,John Daly,195,3,192
2004,0,7363,Craig Bowden,196,193,3
2004,0,20634,Peter Lonard,196,54,142
2004,0,25396,Kevin Na,196,157,39
2004,0,23552,Hank Kuehne,197,1,196
2004,0,10213,Dicky Pride,197,153,44
2004,0,1035,Tommy Armour III,199,70,129
2004,0,1127,Danny Briggs,199,125,74
2004,0,1226,Fred Couples,201,35,166
2004,0,8385,Omar Uresti,201,191,10
2004,0,19881,Robert Damron,202,178,24
2004,0,8339,Spike McRoy,202,145,57
2004,0,1219,John Cook,203,194,9
2004,0,8537,J.P. Hayes,203,152,51
2004,0,6522,Ernie Els,204,19,185
2004,0,21209,Sergio Garcia,204,33,171
2004,0,20572,Rod Pampling,204,50,154
2004,0,24502,Adam Scott,204,30,174
2004,0,1948,Tim Petrovic,205,97,108
2004,0,23613,Rich Barcelo,206,43,163
2004,0,7721,Pat Bates,207,181,26
2004,0,19825,Darren Clarke,208,78,130
2004,0,22405,Justin Rose,208,65,143
2004,0,6515,Shaun Micheel,209,93,116
2004,0,23621,Rory Sabbatini,209,48,161
2004,0,12394,Tom Carter,210,24,186
2004,0,20472,Alex Cejka,210,110,100
2004,0,25345,Carl Pettersson,211,64,147
2004,0,6214,Guy Boros,212,149,63
2004,0,1261,Jay Delsing,212,79,133
2004,0,20663,Brenden Pappas,212,17,195
2004,0,1928,Corey Pavin,212,196,16
2004,0,12782,Tim Herron,213,40,173
2004,0,2104,Jeff Sluman,213,165,48
2004,0,7749,Brett Quigley,214,37,177
2004,0,1926,Steve Pate,216,128,88
2004,0,6251,Chris DiMarco,217,176,41
2004,0,20585,Niclas Fasth,217,77,140
2004,0,23541,Ben Crane,219,125,94
2004,0,7939,Dan Olsen,219,25,194
2004,0,20378,Mathias Grönberg,220,50,170
2004,0,12753,David Morland IV,220,188,32
2004,0,2049,Gene Sauers,220,156,64
2004,0,21407,Arjun Atwal,221,73,148
2004,0,12760,Danny Ellis,221,101,120
2004,0,20382,Stephen Leaney,223,135,88
2004,0,2010,Loren Roberts,223,195,28
2004,0,21949,Joe Ogilvie,224,79,145
2004,0,12823,Carlos Franco,227,69,158
2004,0,6332,Neal Lancaster,227,52,175
2004,0,1761,Len Mattiace,227,173,54
2004,0,6575,Dudley Hart,228,113,115
2004,0,2206,David Toms,228,117,111
2004,0,7457,Steve Flesch,229,161,68
2004,0,1203,Russ Cochran,230,155,75
2004,0,1968,Nick Price,231,188,43
2004,0,6078,Esteban Toledo,231,182,49
2004,0,20593,Greg Chalmers,233,94,139
2004,0,6809,Bob Burns,235,180,55
2004,0,22621,Ben Curtis,235,138,97
2004,0,20229,Stewart Cink,238,70,168
2004,0,6197,Michael Allen,239,60,179
2004,0,1577,Lee Janzen,239,107,132
2004,0,10423,Mike Weir,239,138,101
2004,0,1361,Dan Forsman,240,142,98
2004,0,2245,Grant Waite,240,83,157
2004,0,8881,Tripp Isenhour,242,106,136
2004,0,12660,Jesper Parnevik,242,89,153
2004,0,1132,Mark Brooks,243,184,59
2004,0,1887,Mark O'Meara,245,187,58
2004,0,19846,Brian Gay,248,163,85
2004,0,25237,Kevin Muncrief,248,65,183
2004,0,1707,Steve Lowery,251,79,172
2004,0,1938,David Peoples,251,146,105
2004,0,1378,David Frost,252,186,66
2004,0,12705,Cliff Kresge,253,131,122
2004,0,12602,Dean Wilson,253,136,117
2004,0,1457,Jay Haas,259,183,76
2004,0,1666,Bernhard Langer,260,136,124
2004,0,1771,Blaine McCallister,261,151,110
2004,0,10912,Craig Perks,261,73,188
2004,0,12680,Shigeki Maruyama,264,157,107
2004,0,2002,John Riegger,264,120,144
2004,0,24357,K.J. Choi,266,120,146
2004,0,1320,Bob Estes,272,170,102
2004,0,21731,Freddie Jacobson,273,89,184
2004,0,2223,Bob Tway,275,170,105
2004,0,22371,Aaron Baddeley,278,87,191
2004,0,6613,Tommy Tolles,282,92,190
2004,0,1024,Billy Andrade,283,128,155
2004,0,20104,Ken Duke,287,124,163
2004,0,1920,Craig Parry,288,179,109
2004,0,20121,Todd Fischer,294,157,137
2004,0,1042,Paul Azinger,295,119,176
2004,0,1473,Todd Hamilton,295,128,167
2004,0,20127,Chris Riley,311,176,135
2004,0,23338,David Gossett,312,125,187
2004,0,1329,Brad Faxon,326,185,141
2004,0,6527,Steve Stricker,337,144,193
2004,0,6373,José María Olazábal,353,175,178
2003,0,8337,Mike Heinen,51,8,43
2003,0,20095,Carl Paulson,64,42,22
2003,0,1945,Kenny Perry,69,27,42
2003,0,12510,Chad Campbell,83,31,52
2003,0,1035,Tommy Armour III,91,36,55
2003,0,20645,John Senden,92,53,39
2003,0,7941,Mike Grob,93,87,6
2003,0,23177,Kenneth Staton,95,37,58
2003,0,10885,Robert Allenby,101,28,73
2003,0,6621,Joe Durant,104,94,10
2003,0,2170,Hal Sutton,105,102,3
2003,0,21805,Harrison Frazar,110,18,92
2003,0,20498,Briny Baird,112,52,60
2003,0,23034,Brent Schwarzrock,113,25,88
2003,0,19825,Darren Clarke,120,4,116
2003,0,7223,Brian Bateman,122,20,102
2003,0,8123,Jeff Brehaut,123,79,44
2003,0,22295,Darron Stiles,123,55,68
2003,0,2002,John Riegger,124,100,24
2003,0,8725,Tom Gillis,126,96,30
2003,0,20436,Garrett Willis,126,85,41
2003,0,19824,Craig Barlow,127,37,90
2003,0,1569,Peter Jacobsen,128,119,9
2003,0,10733,Kent Jones,131,95,36
2003,0,10809,Jim Furyk,135,131,4
2003,0,1706,Davis Love III,136,15,121
2003,0,6567,Vijay Singh,139,6,133
2003,0,20574,Mathew Goggin,140,10,130
2003,0,6573,Brandt Jobe,140,51,89
2003,0,10425,Jay Williamson,140,103,37
2003,0,12705,Cliff Kresge,142,96,46
2003,0,20572,Rod Pampling,142,64,78
2003,0,1766,Billy Mayfair,145,113,32
2003,0,20548,Hidemichi Tanaka,145,133,12
2003,0,24925,Jonathan Byrd,146,24,122
2003,0,23338,David Gossett,146,82,64
2003,0,23353,J.J. Henry,146,46,100
2003,0,1938,David Peoples,147,114,33
2003,0,2214,Kirk Triplett,147,128,19
2003,0,19972,José Coceres,150,125,25
2003,0,1619,Skip Kendall,150,142,8
2003,0,20094,Jonathan Kaye,151,22,129
2003,0,8075,Jerry Kelly,151,116,35
2003,0,2246,Duffy Waldorf,152,78,74
2003,0,8793,Tiger Woods,153,11,142
2003,0,26489,Cameron Yancey,156,76,80
2003,0,1553,John Huston,157,107,50
2003,0,20628,Arron Oberholser,157,106,51
2003,0,12652,Cameron Beckman,158,67,91
2003,0,10565,Ian Leggatt,160,28,132
2003,0,1797,Rocco Mediate,161,140,21
2003,0,1724,Jeff Maggert,165,158,7
2003,0,22293,Heath Slocum,165,150,15
2003,0,2106,Chris Smith,165,46,119
2003,0,6522,Ernie Els,166,5,161
2003,0,23125,Brad Elder,169,89,80
2003,0,2101,Joey Sindelar,169,108,61
2003,0,6581,David Sutherland,169,63,106
2003,0,20157,Retief Goosen,171,13,158
2003,0,1685,J.L. Lewis,172,65,107
2003,0,10107,Deane Pappas,174,11,163
2003,0,24502,Adam Scott,174,15,159
2003,0,20472,Alex Cejka,175,110,65
2003,0,12782,Tim Herron,175,58,117
2003,0,8633,Per-Ulrik Johansson,175,82,93
2003,0,2223,Bob Tway,176,72,104
2003,0,21961,Charles Howell III,177,31,146
2003,0,1677,Tom Lehman,178,93,85
2003,0,8375,Paul Stankowski,178,39,139
2003,0,1381,Fred Funk,179,178,1
2003,0,21739,Aaron Barber,180,131,49
2003,0,1723,Andrew Magee,180,14,166
2003,0,19881,Robert Damron,181,176,5
2003,0,20663,Brenden Pappas,181,9,172
2003,0,22548,Patrick Sheehan,181,46,135
2003,0,23621,Rory Sabbatini,182,44,138
2003,0,20029,Notah Begay III,183,165,18
2003,0,26420,Richard Johnson,183,156,27
2003,0,2104,Jeff Sluman,183,138,45
2003,0,24357,K.J. Choi,184,30,154
2003,0,1388,Robert Gamez,184,85,99
2003,0,1475,Donnie Hammond,184,158,26
2003,0,11032,Frank Lickliter II,184,130,54
2003,0,23614,Rich Beem,185,41,144
2003,0,8931,Glen Day,187,156,31
2003,0,8545,Glen Hnatiuk,187,185,2
2003,0,21209,Sergio Garcia,188,7,181
2003,0,23552,Hank Kuehne,188,1,187
2003,0,6332,Neal Lancaster,188,31,157
2003,0,1948,Tim Petrovic,188,112,76
2003,0,23135,Tim Clark,190,180,10
2003,0,1249,John Daly,190,2,188
2003,0,20098,Stuart Appleby,191,35,156
2003,0,1139,Olin Browne,191,177,14
2003,0,7721,Pat Bates,192,164,28
2003,0,1810,Phil Mickelson,192,3,189
2003,0,21878,Mark Wilson,192,127,65
2003,0,1157,Tom Byrum,194,181,13
2003,0,6034,Marco Dawson,194,49,145
2003,0,1361,Dan Forsman,194,124,70
2003,0,12823,Carlos Franco,194,19,175
2003,0,6515,Shaun Micheel,195,71,124
2003,0,2239,Scott Verplank,196,173,23
2003,0,2206,David Toms,197,72,125
2003,0,20099,Doug Barron,198,160,38
2003,0,20634,Peter Lonard,198,50,148
2003,0,8339,Spike McRoy,198,145,53
2003,0,10213,Dicky Pride,198,121,77
2003,0,6595,Kevin Sutherland,198,72,126
2003,0,12661,Todd Barranger,199,17,182
2003,0,10585,Scott McCarron,199,31,168
2003,0,25450,Ty Tryon,200,22,178
2003,0,25692,Akio Sadakata,201,118,83
2003,0,7867,Woody Austin,202,59,143
2003,0,20623,Gavin Coles,202,186,16
2003,0,10423,Mike Weir,202,68,134
2003,0,22621,Ben Curtis,203,119,84
2003,0,1320,Bob Estes,203,147,56
2003,0,23656,Jason Caron,204,25,179
2003,0,22892,Jason Gore,205,21,184
2003,0,23036,Chris Anderson,207,144,63
2003,0,26950,John Morgan,207,56,151
2003,0,2010,Loren Roberts,207,190,17
2003,0,21633,Steve Allan,208,59,149
2003,0,6004,Stephen Ames,208,99,109
2003,0,12645,Brent Geiberger,209,39,170
2003,0,1928,Corey Pavin,209,189,20
2003,0,24356,Jason Buha,210,59,151
2003,0,10860,Justin Leonard,212,150,62
2003,0,24361,Pat Perez,212,89,123
2003,0,1175,Jim Carter,213,141,72
2003,0,1707,Steve Lowery,213,72,141
2003,0,22913,John Rollins,213,115,98
2003,0,1161,Mark Calcavecchia,214,87,127
2003,0,6251,Chris DiMarco,214,135,79
2003,0,23983,Luke Donald,214,174,40
2003,0,25031,Andy Miller,215,44,171
2003,0,6643,Paul Goydos,216,187,29
2003,0,22046,Geoff Ogilvy,217,53,164
2003,0,7457,Steve Flesch,218,100,118
2003,0,6809,Bob Burns,219,160,59
2003,0,1226,Fred Couples,222,42,180
2003,0,6475,Jeff Klein,222,188,34
2003,0,2049,Gene Sauers,226,169,57
2003,0,1307,Joel Edwards,227,133,94
2003,0,8547,John Maginnes,227,179,48
2003,0,12662,Thomas Levet,228,92,136
2003,0,1968,Nick Price,228,143,85
2003,0,12755,Vance Veazey,229,56,173
2003,0,20771,Steven Alker,230,183,47
2003,0,20940,Kenichi Kuboya,230,135,95
2003,0,6617,Brian Henninger,231,103,128
2003,0,11011,Mike Sposa,231,76,155
2003,0,20566,Kaname Yokoo,231,126,105
2003,0,1941,Tom Pernice Jr.,232,70,162
2003,0,23541,Ben Crane,233,68,165
2003,0,23108,Matt Kuchar,239,174,65
2003,0,6078,Esteban Toledo,239,170,69
2003,0,12602,Dean Wilson,241,154,87
2003,0,10201,Matt Gogel,242,160,82
2003,0,21806,Paul Gow,242,96,146
2003,0,12388,Michael Clark II,247,146,101
2003,0,8537,J.P. Hayes,247,172,75
2003,0,10912,Craig Perks,247,62,185
2003,0,12680,Shigeki Maruyama,248,152,96
2003,0,20568,Anthony Painter,248,89,159
2003,0,7749,Brett Quigley,249,66,183
2003,0,20573,Scott Laycock,251,138,113
2003,0,20593,Greg Chalmers,254,80,174
2003,0,1132,Mark Brooks,255,184,71
2003,0,12660,Jesper Parnevik,255,135,120
2003,0,1577,Lee Janzen,256,105,151
2003,0,1098,Jay Don Blake,257,154,103
2003,0,20127,Chris Riley,257,147,110
2003,0,20229,Stewart Cink,258,81,177
2003,0,7101,Dave Stockton Jr.,261,121,140
2003,0,1457,Jay Haas,264,149,115
2003,0,1378,David Frost,265,168,97
2003,0,1761,Len Mattiace,265,153,112
2003,0,25345,Carl Pettersson,265,128,137
2003,0,22371,Aaron Baddeley,268,82,186
2003,0,20121,Todd Fischer,271,121,150
2003,0,19846,Brian Gay,271,160,111
2003,0,6575,Dudley Hart,272,165,107
2003,0,1024,Billy Andrade,279,110,169
2003,0,1042,Paul Azinger,284,117,167
2003,0,1666,Bernhard Langer,296,182,114
2003,0,1887,Mark O'Meara,298,167,131
2003,0,6527,Steve Stricker,299,109,190
2003,0,1329,Brad Faxon,347,171,176
2002,0,21961,Charles Howell III,70,4,66
2002,0,2106,Chris Smith,83,9,74
2002,0,10885,Robert Allenby,85,36,49
2002,0,21209,Sergio Garcia,99,14,85
2002,0,23353,J.J. Henry,99,26,73
2002,0,20548,Hidemichi Tanaka,104,86,18
2002,0,26289,Boo Weekley,110,2,108
2002,0,20498,Briny Baird,111,71,40
2002,0,8633,Per-Ulrik Johansson,111,66,45
2002,0,20029,Notah Begay III,112,90,22
2002,0,8793,Tiger Woods,113,6,107
2002,0,20645,John Senden,115,19,96
2002,0,12510,Chad Campbell,117,82,35
2002,0,24925,Jonathan Byrd,119,14,105
2002,0,1388,Robert Gamez,120,68,52
2002,0,1569,Peter Jacobsen,121,82,39
2002,0,1945,Kenny Perry,124,37,87
2002,0,20095,Carl Paulson,127,30,97
2002,0,2246,Duffy Waldorf,128,52,76
2002,0,7223,Brian Bateman,130,26,104
2002,0,1577,Lee Janzen,131,60,71
2002,0,23177,Kenneth Staton,131,32,99
2002,0,23338,David Gossett,132,89,43
2002,0,10962,Bradley Hughes,132,86,46
2002,0,20094,Jonathan Kaye,134,39,95
2002,0,22913,John Rollins,141,112,29
2002,0,1475,Donnie Hammond,143,117,26
2002,0,10860,Justin Leonard,143,119,24
2002,0,6567,Vijay Singh,143,46,97
2002,0,1797,Rocco Mediate,146,126,20
2002,0,12652,Cameron Beckman,147,71,76
2002,0,7457,Steve Flesch,147,45,102
2002,0,2002,John Riegger,150,109,41
2002,0,1553,John Huston,151,81,70
2002,0,8545,Glen Hnatiuk,152,144,8
2002,0,6573,Brandt Jobe,152,42,110
2002,0,1677,Tom Lehman,152,63,89
2002,0,1142,Bart Bryant,153,142,11
2002,0,1810,Phil Mickelson,154,25,129
2002,0,11032,Frank Lickliter II,155,63,92
2002,0,12823,Carlos Franco,156,13,143
2002,0,2101,Joey Sindelar,156,42,114
2002,0,2133,Craig Stadler,156,98,58
2002,0,1685,J.L. Lewis,157,42,115
2002,0,1307,Joel Edwards,158,125,33
2002,0,23614,Rich Beem,159,10,149
2002,0,19881,Robert Damron,159,123,36
2002,0,2214,Kirk Triplett,160,145,15
2002,0,7003,David Berganio Jr.,161,55,106
2002,0,23135,Tim Clark,161,140,21
2002,0,20572,Rod Pampling,161,41,120
2002,0,6621,Joe Durant,162,152,10
2002,0,1320,Bob Estes,162,105,57
2002,0,1706,Davis Love III,162,30,132
2002,0,1724,Jeff Maggert,163,150,13
2002,0,1948,Tim Petrovic,163,92,71
2002,0,1381,Fred Funk,164,163,1
2002,0,2170,Hal Sutton,164,126,38
2002,0,6515,Shaun Micheel,165,53,112
2002,0,6004,Stephen Ames,167,73,94
2002,0,8123,Jeff Brehaut,168,99,69
2002,0,2206,David Toms,168,114,54
2002,0,23623,Bo Van Pelt,168,11,157
2002,0,1161,Mark Calcavecchia,170,47,123
2002,0,1938,David Peoples,171,92,79
2002,0,8881,Tripp Isenhour,172,33,139
2002,0,21805,Harrison Frazar,173,14,159
2002,0,20436,Garrett Willis,173,111,62
2002,0,12388,Michael Clark II,174,55,119
2002,0,2223,Bob Tway,174,61,113
2002,0,1968,Nick Price,175,166,9
2002,0,23322,Brett Wetterich,175,8,167
2002,0,20634,Peter Lonard,176,84,92
2002,0,23541,Ben Crane,177,39,138
2002,0,10809,Jim Furyk,177,173,4
2002,0,20574,Mathew Goggin,178,3,175
2002,0,1707,Steve Lowery,178,94,84
2002,0,1771,Blaine McCallister,181,150,31
2002,0,1175,Jim Carter,183,141,42
2002,0,12645,Brent Geiberger,184,66,118
2002,0,20566,Kaname Yokoo,184,94,90
2002,0,20157,Retief Goosen,185,105,80
2002,0,24361,Pat Perez,185,94,91
2002,0,10565,Ian Leggatt,186,35,151
2002,0,9011,David Duval,187,11,176
2002,0,8375,Paul Stankowski,188,34,154
2002,0,23108,Matt Kuchar,189,161,28
2002,0,1920,Craig Parry,189,121,68
2002,0,20098,Stuart Appleby,190,23,167
2002,0,8931,Glen Day,190,184,6
2002,0,6251,Chris DiMarco,190,108,82
2002,0,7721,Pat Bates,191,174,17
2002,0,2239,Scott Verplank,191,189,2
2002,0,10585,Scott McCarron,192,47,145
2002,0,22293,Heath Slocum,192,189,3
2002,0,23983,Luke Donald,193,156,37
2002,0,1203,Russ Cochran,194,69,125
2002,0,1035,Tommy Armour III,195,74,121
2002,0,6643,Paul Goydos,195,176,19
2002,0,1157,Tom Byrum,196,182,14
2002,0,1249,John Daly,196,1,195
2002,0,20043,Edward Fryatt,196,55,141
2002,0,1927,Dennis Paulson,196,4,192
2002,0,12753,David Morland IV,197,136,61
2002,0,1139,Olin Browne,198,191,7
2002,0,22046,Geoff Ogilvy,198,21,177
2002,0,10425,Jay Williamson,198,139,59
2002,0,1014,Fulton Allem,200,195,5
2002,0,23903,Stephen Gangluff,200,38,162
2002,0,10457,Frank Nobilo,200,153,47
2002,0,12826,Paul Claxton,202,168,34
2002,0,19824,Craig Barlow,203,51,152
2002,0,12782,Tim Herron,203,7,196
2002,0,6498,Matt Peterson,203,180,23
2002,0,21633,Steve Allan,204,20,184
2002,0,1766,Billy Mayfair,204,179,25
2002,0,1761,Len Mattiace,205,130,75
2002,0,1926,Steve Pate,205,88,117
2002,0,8075,Jerry Kelly,206,158,48
2002,0,24357,K.J. Choi,208,62,146
2002,0,1514,Eduardo Herrera,208,18,190
2002,0,6016,Brad Lardon,209,145,64
2002,0,23621,Rory Sabbatini,209,23,186
2002,0,10733,Kent Jones,210,124,86
2002,0,12663,Phil Tataurangi,211,26,185
2002,0,6809,Bob Burns,213,160,53
2002,0,1599,Steve Jones,213,130,83
2002,0,1928,Corey Pavin,213,201,12
2002,0,1226,Fred Couples,214,26,188
2002,0,6613,Tommy Tolles,214,22,192
2002,0,1219,John Cook,215,199,16
2002,0,20663,Brenden Pappas,217,17,200
2002,0,1361,Dan Forsman,218,153,65
2002,0,1374,Robin Freeman,218,74,144
2002,0,2010,Loren Roberts,219,192,27
2002,0,20127,Chris Riley,222,166,56
2002,0,2245,Grant Waite,223,58,165
2002,0,1941,Tom Pernice Jr.,225,103,122
2002,0,8553,Lee Porter,225,196,29
2002,0,1619,Skip Kendall,229,174,55
2002,0,10423,Mike Weir,230,100,130
2002,0,19846,Brian Gay,232,172,60
2002,0,1132,Mark Brooks,234,183,51
2002,0,6315,Pete Jordan,234,202,32
2002,0,19958,Miguel Angel Jiménez,235,157,78
2002,0,6527,Steve Stricker,238,49,189
2002,0,21806,Paul Gow,240,80,160
2002,0,6332,Neal Lancaster,240,76,164
2002,0,11011,Mike Sposa,241,153,88
2002,0,6078,Esteban Toledo,241,197,44
2002,0,20105,Jeff Gove,242,118,124
2002,0,1098,Jay Don Blake,245,178,67
2002,0,1723,Andrew Magee,245,65,180
2002,0,2104,Jeff Sluman,245,164,81
2002,0,6522,Ernie Els,247,84,163
2002,0,1527,Scott Hoch,247,184,63
2002,0,12680,Shigeki Maruyama,248,100,148
2002,0,6197,Michael Allen,249,50,199
2002,0,19972,José Coceres,250,200,50
2002,0,24937,Jess Daley,250,78,172
2002,0,23125,Brad Elder,250,100,150
2002,0,21259,Jason Hill,251,78,173
2002,0,6617,Brian Henninger,252,121,131
2002,0,10107,Deane Pappas,255,58,197
2002,0,8537,J.P. Hayes,256,129,127
2002,0,10117,Bob Heintz,256,54,202
2002,0,7867,Woody Austin,258,103,155
2002,0,8993,Franklin Langham,262,135,127
2002,0,1313,Steve Elkington,263,94,169
2002,0,20502,Michael Long,263,76,187
2002,0,7749,Brett Quigley,264,70,194
2002,0,6575,Dudley Hart,267,132,135
2002,0,6036,Scott Dunlap,269,168,101
2002,0,8339,Spike McRoy,269,136,133
2002,0,1185,Brandel Chamblee,271,168,103
2002,0,6595,Kevin Sutherland,271,145,126
2002,0,1024,Billy Andrade,275,105,170
2002,0,20229,Stewart Cink,275,109,166
2002,0,10201,Matt Gogel,275,136,139
2002,0,1887,Mark O'Meara,279,145,134
2002,0,20593,Greg Chalmers,281,90,191
2002,0,6350,Bob May,281,145,136
2002,0,2110,Jerry Smith,284,142,142
2002,0,1666,Bernhard Langer,285,176,109
2002,0,21949,Joe Ogilvie,285,114,171
2002,0,1329,Brad Faxon,286,186,100
2002,0,10649,Tom Scherrer,286,112,174
2002,0,10213,Dicky Pride,288,133,155
2002,0,12660,Jesper Parnevik,296,114,182
2002,0,10912,Craig Perks,297,120,177
2002,0,1378,David Frost,298,187,111
2002,0,1457,Jay Haas,299,162,137
2002,0,23800,Bryce Molder,307,126,181
2002,0,6012,Greg Kraft,310,194,116
2002,0,8535,Gary Nicklaus,311,158,153
2002,0,1042,Paul Azinger,313,134,179
2002,0,2257,Brian Watts,322,165,157
2002,0,2099,Scott Simpson,345,198,147
2002,0,2322,Richard Zokol,349,188,161
2002,0,1549,Mike Hulbert,372,171,201
2002,0,19817,Michael Muehr,375,192,183
2002,0,6373,José María Olazábal,379,181,198
2001,0,21209,Sergio Garcia,47,22,25
2001,0,23034,Brent Schwarzrock,47,27,20
2001,0,21961,Charles Howell III,62,6,56
2001,0,1475,Donnie Hammond,82,39,43
2001,0,7003,David Berganio Jr.,84,31,53
2001,0,6621,Joe Durant,84,83,1
2001,0,23353,J.J. Henry,84,26,58
2001,0,1810,Phil Mickelson,84,6,78
2001,0,20095,Carl Paulson,92,69,23
2001,0,11032,Frank Lickliter II,98,37,61
2001,0,6573,Brandt Jobe,103,13,90
2001,0,10885,Robert Allenby,106,37,69
2001,0,10585,Scott McCarron,106,14,92
2001,0,1945,Kenny Perry,110,10,100
2001,0,2106,Chris Smith,112,9,103
2001,0,2170,Hal Sutton,114,103,11
2001,0,1063,Ben Bates,122,49,73
2001,0,23614,Rich Beem,122,47,75
2001,0,1677,Tom Lehman,122,25,97
2001,0,20094,Jonathan Kaye,124,54,70
2001,0,6004,Stephen Ames,129,65,64
2001,0,20498,Briny Baird,129,67,62
2001,0,2002,John Riegger,129,93,36
2001,0,1707,Steve Lowery,132,79,53
2001,0,20098,Stuart Appleby,134,19,115
2001,0,2246,Duffy Waldorf,134,39,95
2001,0,22122,Andrew McLardy,137,49,88
2001,0,2206,David Toms,137,95,42
2001,0,20566,Kaname Yokoo,137,57,80
2001,0,12645,Brent Geiberger,138,81,57
2001,0,1724,Jeff Maggert,139,98,41
2001,0,8633,Per-Ulrik Johansson,140,74,66
2001,0,8057,Brian Wilson,140,18,122
2001,0,1035,Tommy Armour III,143,62,81
2001,0,1203,Russ Cochran,145,95,50
2001,0,1938,David Peoples,145,90,55
2001,0,2245,Grant Waite,145,36,109
2001,0,1766,Billy Mayfair,146,141,5
2001,0,8793,Tiger Woods,148,3,145
2001,0,21584,Richie Coughlan,149,115,34
2001,0,1307,Joel Edwards,150,129,21
2001,0,1139,Olin Browne,151,145,6
2001,0,10565,Ian Leggatt,151,63,88
2001,0,6567,Vijay Singh,151,23,128
2001,0,1527,Scott Hoch,152,133,19
2001,0,19881,Robert Damron,153,126,27
2001,0,9011,David Duval,153,5,148
2001,0,10962,Bradley Hughes,154,121,33
2001,0,21805,Harrison Frazar,155,24,131
2001,0,20433,Mark Hensby,157,90,67
2001,0,12652,Cameron Beckman,158,32,126
2001,0,1313,Steve Elkington,158,81,77
2001,0,12782,Tim Herron,158,17,141
2001,0,1797,Rocco Mediate,158,107,51
2001,0,1161,Mark Calcavecchia,160,28,132
2001,0,19972,José Coceres,160,151,9
2001,0,7457,Steve Flesch,160,54,106
2001,0,12660,Jesper Parnevik,161,45,116
2001,0,2223,Bob Tway,161,98,63
2001,0,22892,Jason Gore,162,12,150
2001,0,23125,Brad Elder,164,53,111
2001,0,1175,Jim Carter,165,141,24
2001,0,8375,Paul Stankowski,166,32,134
2001,0,1706,Davis Love III,167,3,164
2001,0,1381,Fred Funk,168,165,3
2001,0,22046,Geoff Ogilvy,168,48,120
2001,0,20127,Chris Riley,170,126,44
2001,0,10809,Jim Furyk,171,164,7
2001,0,6809,Bob Burns,173,105,68
2001,0,6036,Scott Dunlap,174,129,45
2001,0,1920,Craig Parry,174,157,17
2001,0,2101,Joey Sindelar,174,11,163
2001,0,8545,Glen Hnatiuk,176,174,2
2001,0,1157,Tom Byrum,177,169,8
2001,0,1219,John Cook,178,174,4
2001,0,20436,Garrett Willis,178,93,85
2001,0,1226,Fred Couples,180,21,159
2001,0,2257,Brian Watts,181,67,114
2001,0,1619,Skip Kendall,182,160,22
2001,0,7749,Brett Quigley,182,2,180
2001,0,6522,Ernie Els,183,30,153
2001,0,1943,Chris Perry,183,107,76
2001,0,2239,Scott Verplank,183,170,13
2001,0,10201,Matt Gogel,184,85,99
2001,0,10457,Frank Nobilo,184,150,34
2001,0,8553,Lee Porter,184,146,38
2001,0,12760,Danny Ellis,186,28,158
2001,0,21007,Gabriel Hjertstedt,186,74,112
2001,0,20593,Greg Chalmers,187,105,82
2001,0,1771,Blaine McCallister,187,171,16
2001,0,11011,Mike Sposa,187,113,74
2001,0,8931,Glen Day,188,159,29
2001,0,1249,John Daly,189,1,188
2001,0,1968,Nick Price,189,149,40
2001,0,10213,Dicky Pride,190,138,52
2001,0,2214,Kirk Triplett,190,178,12
2001,0,1042,Paul Azinger,191,95,96
2001,0,20574,Mathew Goggin,191,35,156
2001,0,8537,J.P. Hayes,191,120,71
2001,0,21633,Steve Allan,192,8,184
2001,0,12388,Michael Clark II,193,83,110
2001,0,19824,Craig Barlow,194,64,130
2001,0,8075,Jerry Kelly,194,107,87
2001,0,10860,Justin Leonard,195,135,60
2001,0,10912,Craig Perks,195,52,143
2001,0,6431,Jean Van de Velde,195,167,28
2001,0,19846,Brian Gay,196,186,10
2001,0,10423,Mike Weir,196,44,152
2001,0,8063,Kelly Grunewald,197,15,182
2001,0,25083,Jeremy Anderson,198,60,138
2001,0,1487,Jeff Hart,198,184,14
2001,0,1685,J.L. Lewis,198,57,141
2001,0,1457,Jay Haas,200,154,46
2001,0,1553,John Huston,200,92,108
2001,0,23621,Rory Sabbatini,201,20,181
2001,0,6613,Tommy Tolles,202,45,157
2001,0,6034,Marco Dawson,203,34,169
2001,0,6350,Bob May,203,86,117
2001,0,8123,Jeff Brehaut,205,133,72
2001,0,6575,Dudley Hart,205,39,166
2001,0,12714,Chris Tidland,205,16,189
2001,0,1132,Mark Brooks,206,191,15
2001,0,12823,Carlos Franco,206,39,167
2001,0,10733,Kent Jones,206,147,59
2001,0,6315,Pete Jordan,207,189,18
2001,0,1388,Robert Gamez,211,162,49
2001,0,1823,Larry Mize,211,172,39
2001,0,6514,Kevin Johnson,212,39,173
2001,0,6617,Brian Henninger,213,122,91
2001,0,1014,Fulton Allem,214,183,31
2001,0,1024,Billy Andrade,216,87,129
2001,0,1418,Bill Glasson,217,138,79
2001,0,6332,Neal Lancaster,217,132,85
2001,0,1098,Jay Don Blake,218,181,37
2001,0,1185,Brandel Chamblee,218,153,65
2001,0,6643,Paul Goydos,218,186,32
2001,0,10425,Jay Williamson,218,135,83
2001,0,1928,Corey Pavin,220,194,26
2001,0,12705,Cliff Kresge,222,78,144
2001,0,6078,Esteban Toledo,222,192,30
2001,0,1361,Dan Forsman,224,177,47
2001,0,6090,Jim McGovern,224,54,170
2001,0,7763,Doug Dunakey,225,79,146
2001,0,20043,Edward Fryatt,227,100,127
2001,0,6515,Shaun Micheel,227,87,140
2001,0,1374,Robin Freeman,228,77,151
2001,0,12753,David Morland IV,228,107,121
2001,0,2110,Jerry Smith,230,125,105
2001,0,24357,K.J. Choi,233,59,174
2001,0,2104,Jeff Sluman,233,72,161
2001,0,2218,Ted Tryba,233,114,119
2001,0,7867,Woody Austin,235,141,94
2001,0,8881,Tripp Isenhour,235,151,84
2001,0,21949,Joe Ogilvie,235,102,133
2001,0,1320,Bob Estes,236,112,124
2001,0,12680,Shigeki Maruyama,238,89,149
2001,0,1941,Tom Pernice Jr.,238,66,172
2001,0,20229,Stewart Cink,240,69,171
2001,0,6251,Chris DiMarco,240,103,137
2001,0,21806,Paul Gow,240,117,123
2001,0,2010,Loren Roberts,240,193,47
2001,0,1093,Ronnie Black,241,49,192
2001,0,1577,Lee Janzen,242,138,104
2001,0,1599,Steve Jones,242,124,118
2001,0,1723,Andrew Magee,246,61,185
2001,0,6595,Kevin Sutherland,252,116,136
2001,0,1761,Len Mattiace,256,154,102
2001,0,1927,Dennis Paulson,258,72,186
2001,0,8339,Spike McRoy,261,160,101
2001,0,2099,Scott Simpson,261,163,98
2001,0,6527,Steve Stricker,263,69,194
2001,0,24604,Hunter Haas,265,74,191
2001,0,10963,Jimmy Green,272,117,155
2001,0,1666,Bernhard Langer,272,179,93
2001,0,6591,Rocky Walcher,272,107,165
2001,0,2279,Mark Wiebe,273,166,107
2001,0,22051,Ben Ferguson,276,101,175
2001,0,1926,Steve Pate,290,129,161
2001,0,6012,Greg Kraft,295,182,113
2001,0,8535,Gary Nicklaus,296,128,168
2001,0,7101,Dave Stockton Jr.,297,119,178
2001,0,1329,Brad Faxon,301,147,154
2001,0,6140,Sean Murphy,309,174,135
2001,0,7547,Craig Kanada,310,123,187
2001,0,1200,Keith Clearwater,313,137,176
2001,0,6373,José María Olazábal,313,188,125
2001,0,1378,David Frost,318,179,139
2001,0,20099,Doug Barron,328,168,160
2001,0,8993,Franklin Langham,332,185,147
2001,0,1887,Mark O'Meara,335,156,179
2001,0,1603,Jeff Julian,337,144,193
2001,0,19817,Michael Muehr,341,158,183
2001,0,10649,Tom Scherrer,350,173,177
2001,0,2294,Willie Wood,380,190,190
2000,0,8793,Tiger Woods,56,2,54
2000,0,9011,David Duval,58,18,40
2000,0,21209,Sergio Garcia,65,39,26
2000,0,21805,Harrison Frazar,67,7,60
2000,0,10885,Robert Allenby,75,10,65
2000,0,1161,Mark Calcavecchia,86,31,55
2000,0,6522,Ernie Els,89,38,51
2000,0,1707,Steve Lowery,91,52,39
2000,0,20095,Carl Paulson,92,14,78
2000,0,2170,Hal Sutton,97,67,30
2000,0,1943,Chris Perry,99,75,24
2000,0,10425,Jay Williamson,106,63,43
2000,0,1797,Rocco Mediate,108,88,20
2000,0,6036,Scott Dunlap,109,78,31
2000,0,1307,Joel Edwards,110,68,42
2000,0,1418,Bill Glasson,115,27,88
2000,0,1945,Kenny Perry,117,21,96
2000,0,6621,Joe Durant,118,116,2
2000,0,20094,Jonathan Kaye,121,71,50
2000,0,1724,Jeff Maggert,121,105,16
2000,0,12388,Michael Clark II,122,22,100
2000,0,20574,Mathew Goggin,123,9,114
2000,0,2206,David Toms,124,68,56
2000,0,2214,Kirk Triplett,125,90,35
2000,0,7457,Steve Flesch,126,32,94
2000,0,1810,Phil Mickelson,130,3,127
2000,0,20593,Greg Chalmers,134,42,92
2000,0,1920,Craig Parry,134,122,12
2000,0,1938,David Peoples,134,43,91
2000,0,1968,Nick Price,134,97,37
2000,0,1569,Peter Jacobsen,136,63,73
2000,0,2245,Grant Waite,136,33,103
2000,0,1706,Davis Love III,139,3,136
2000,0,6567,Vijay Singh,142,30,112
2000,0,1035,Tommy Armour III,144,28,116
2000,0,19881,Robert Damron,144,34,110
2000,0,12645,Brent Geiberger,144,86,58
2000,0,23125,Brad Elder,146,56,90
2000,0,2239,Scott Verplank,146,143,3
2000,0,20043,Edward Fryatt,147,61,86
2000,0,1577,Lee Janzen,147,83,64
2000,0,10809,Jim Furyk,150,136,14
2000,0,10860,Justin Leonard,150,105,45
2000,0,1313,Steve Elkington,152,81,71
2000,0,6251,Chris DiMarco,154,48,106
2000,0,1408,Kelly Gibson,155,15,140
2000,0,1677,Tom Lehman,155,103,52
2000,0,1326,Nick Faldo,157,147,10
2000,0,1975,Tom Purtzer,157,34,123
2000,0,7867,Woody Austin,158,81,77
2000,0,23614,Rich Beem,158,45,113
2000,0,20445,Casey Martin,158,6,152
2000,0,12660,Jesper Parnevik,159,93,66
2000,0,1771,Blaine McCallister,160,140,20
2000,0,24357,K.J. Choi,162,73,89
2000,0,11032,Frank Lickliter II,162,139,23
2000,0,6350,Bob May,162,57,105
2000,0,1381,Fred Funk,163,162,1
2000,0,1157,Tom Byrum,164,153,11
2000,0,19824,Craig Barlow,165,24,141
2000,0,12782,Tim Herron,165,12,153
2000,0,1139,Olin Browne,166,160,6
2000,0,1185,Brandel Chamblee,166,97,69
2000,0,1761,Len Mattiace,167,97,70
2000,0,10457,Frank Nobilo,168,127,41
2000,0,20029,Notah Begay III,169,93,76
2000,0,8375,Paul Stankowski,169,19,150
2000,0,1388,Robert Gamez,170,126,44
2000,0,6004,Stephen Ames,171,78,93
2000,0,6575,Dudley Hart,171,110,61
2000,0,1599,Steve Jones,171,41,130
2000,0,1219,John Cook,172,143,29
2000,0,1619,Skip Kendall,172,125,47
2000,0,6809,Bob Burns,173,48,125
2000,0,1766,Billy Mayfair,173,151,22
2000,0,20098,Stuart Appleby,174,8,166
2000,0,6581,David Sutherland,177,90,87
2000,0,1527,Scott Hoch,178,131,47
2000,0,8075,Jerry Kelly,178,80,98
2000,0,6515,Shaun Micheel,178,52,126
2000,0,1823,Larry Mize,178,173,5
2000,0,2246,Duffy Waldorf,178,19,159
2000,0,12680,Shigeki Maruyama,183,26,157
2000,0,21949,Joe Ogilvie,183,54,129
2000,0,1723,Andrew Magee,184,39,145
2000,0,10585,Scott McCarron,185,5,180
2000,0,24356,Jason Buha,186,75,111
2000,0,7763,Doug Dunakey,186,37,149
2000,0,19846,Brian Gay,187,170,17
2000,0,8931,Glen Day,188,150,38
2000,0,8993,Franklin Langham,188,93,95
2000,0,12652,Cameron Beckman,189,29,160
2000,0,6044,Scott Gump,189,182,7
2000,0,23621,Rory Sabbatini,189,11,178
2000,0,8545,Glen Hnatiuk,190,182,8
2000,0,1553,John Huston,190,86,104
2000,0,1249,John Daly,191,1,190
2000,0,6573,Brandt Jobe,191,23,168
2000,0,6315,Pete Jordan,191,182,9
2000,0,20105,Jeff Gove,192,90,102
2000,0,10649,Tom Scherrer,192,84,108
2000,0,1142,Bart Bryant,194,176,18
2000,0,1927,Dennis Paulson,194,15,179
2000,0,2110,Jerry Smith,194,175,19
2000,0,2279,Mark Wiebe,194,141,53
2000,0,1014,Fulton Allem,195,168,27
2000,0,1685,J.L. Lewis,195,34,161
2000,0,1926,Steve Pate,195,127,68
2000,0,1226,Fred Couples,196,13,183
2000,0,1533,P.H. Horgan III,196,168,28
2000,0,10962,Bradley Hughes,196,116,80
2000,0,2010,Loren Roberts,196,192,4
2000,0,2218,Ted Tryba,196,57,139
2000,0,10423,Mike Weir,196,112,84
2000,0,1042,Paul Azinger,198,50,148
2000,0,10963,Jimmy Green,198,135,63
2000,0,6062,Charles Raulerson,198,47,151
2000,0,6617,Brian Henninger,199,116,83
2000,0,10569,Mike Brisky,201,156,45
2000,0,8547,John Maginnes,201,188,13
2000,0,1191,Barry Cheesman,203,17,186
2000,0,20127,Chris Riley,203,104,99
2000,0,8243,Aaron Bengoechea,206,25,181
2000,0,6140,Sean Murphy,208,123,85
2000,0,20229,Stewart Cink,209,45,164
2000,0,1996,Mike Reid,209,194,15
2000,0,6643,Paul Goydos,212,179,33
2000,0,6595,Kevin Sutherland,213,93,120
2000,0,6078,Esteban Toledo,215,190,25
2000,0,1063,Ben Bates,217,89,128
2000,0,1376,Bob Friend,218,186,32
2000,0,1320,Bob Estes,220,146,74
2000,0,1374,Robin Freeman,220,73,147
2000,0,6431,Jean Van de Velde,220,62,158
2000,0,7363,Craig Bowden,223,187,36
2000,0,22913,John Rollins,223,50,173
2000,0,1098,Jay Don Blake,224,165,59
2000,0,1132,Mark Brooks,226,177,49
2000,0,21007,Gabriel Hjertstedt,226,119,107
2000,0,1203,Russ Cochran,228,72,156
2000,0,6012,Greg Kraft,229,154,75
2000,0,1928,Corey Pavin,229,195,34
2000,0,8385,Omar Uresti,229,157,72
2000,0,2101,Joey Sindelar,230,97,133
2000,0,2133,Craig Stadler,231,57,174
2000,0,7749,Brett Quigley,232,57,175
2000,0,19822,Bobby Cochran,234,65,169
2000,0,10117,Bob Heintz,236,44,192
2000,0,8537,J.P. Hayes,237,120,117
2000,0,1261,Jay Delsing,239,85,154
2000,0,21593,Keith Nolan,239,182,57
2000,0,1905,Joe Ozaki,240,159,81
2000,0,6088,Steve Gotsche,243,112,131
2000,0,12753,David Morland IV,244,112,132
2000,0,1457,Jay Haas,246,164,82
2000,0,6527,Steve Stricker,246,55,191
2000,0,1329,Brad Faxon,250,171,79
2000,0,2257,Brian Watts,251,133,118
2000,0,1941,Tom Pernice Jr.,254,130,124
2000,0,1116,Michael Bradley,255,66,189
2000,0,11653,Paul Curry,255,193,62
2000,0,12823,Carlos Franco,255,68,187
2000,0,1489,Steve Hart,255,188,67
2000,0,6332,Neal Lancaster,255,112,143
2000,0,10912,Craig Perks,257,102,155
2000,0,1361,Dan Forsman,258,143,115
2000,0,6090,Jim McGovern,258,123,135
2000,0,2104,Jeff Sluman,264,167,97
2000,0,20099,Doug Barron,269,147,122
2000,0,1093,Ronnie Black,270,133,137
2000,0,10213,Dicky Pride,270,161,109
2000,0,6613,Tommy Tolles,270,75,195
2000,0,22064,Craig Spence,273,97,176
2000,0,23656,Jason Caron,275,105,170
2000,0,11011,Mike Sposa,275,110,165
2000,0,2223,Bob Tway,275,131,144
2000,0,1024,Billy Andrade,277,105,172
2000,0,1323,Brad Fabel,278,177,101
2000,0,7101,Dave Stockton Jr.,278,157,121
2000,0,1175,Jim Carter,282,163,119
2000,0,10201,Matt Gogel,285,147,138
2000,0,6014,Eric Booker,286,109,177
2000,0,8045,Perry Moss,288,121,167
2000,0,8535,Gary Nicklaus,305,142,163
2000,0,12449,Ryan Howison,313,171,142
2000,0,1331,Rick Fehr,314,129,185
2000,0,1510,Nolan Henke,314,180,134
2000,0,1378,David Frost,319,173,146
2000,0,1282,Trevor Dodds,326,138,188
2000,0,1040,Emlyn Aubrey,328,166,162
2000,0,7753,Kevin Wentworth,330,137,193
2000,0,1887,Mark O'Meara,336,152,184
2000,0,2131,Mike Springer,337,155,182
2000,0,1072,Chip Beck,362,191,171
2000,0,1549,Mike Hulbert,375,181,194
1999,0,9011,David Duval,35,9,26
1999,0,1706,Davis Love III,42,17,25
1999,0,2170,Hal Sutton,56,52,4
1999,0,8793,Tiger Woods,68,3,65
1999,0,2246,Duffy Waldorf,80,27,53
1999,0,8045,Perry Moss,83,40,43
1999,0,2245,Grant Waite,88,22,66
1999,0,1945,Kenny Perry,89,22,67
1999,0,2214,Kirk Triplett,89,52,37
1999,0,1968,Nick Price,90,81,9
1999,0,6522,Ernie Els,93,38,55
1999,0,12782,Tim Herron,96,12,84
1999,0,6036,Scott Dunlap,103,83,20
1999,0,10962,Bradley Hughes,103,80,23
1999,0,1905,Joe Ozaki,106,90,16
1999,0,10885,Robert Allenby,107,31,76
1999,0,1418,Bill Glasson,111,34,77
1999,0,8931,Glen Day,115,97,18
1999,0,1724,Jeff Maggert,117,116,1
1999,0,1810,Phil Mickelson,118,11,107
1999,0,6621,Joe Durant,121,114,7
1999,0,1381,Fred Funk,121,119,2
1999,0,6575,Dudley Hart,124,55,69
1999,0,12660,Jesper Parnevik,124,92,32
1999,0,1943,Chris Perry,124,44,80
1999,0,6567,Vijay Singh,125,13,112
1999,0,1040,Emlyn Aubrey,128,50,78
1999,0,1766,Billy Mayfair,129,119,10
1999,0,10423,Mike Weir,129,70,59
1999,0,10860,Justin Leonard,131,101,30
1999,0,2239,Scott Verplank,133,104,29
1999,0,1797,Rocco Mediate,135,100,35
1999,0,1553,John Huston,141,92,49
1999,0,2223,Bob Tway,141,77,64
1999,0,1035,Tommy Armour III,143,19,124
1999,0,1723,Andrew Magee,144,27,117
1999,0,1320,Bob Estes,146,127,19
1999,0,1761,Len Mattiace,146,112,34
1999,0,1161,Mark Calcavecchia,148,74,74
1999,0,1313,Steve Elkington,148,122,26
1999,0,1619,Skip Kendall,149,109,40
1999,0,6004,Stephen Ames,150,102,48
1999,0,1677,Tom Lehman,150,61,89
1999,0,20029,Notah Begay III,151,14,137
1999,0,23349,Charles Warren,151,15,136
1999,0,1685,J.L. Lewis,153,31,122
1999,0,21805,Harrison Frazar,154,5,149
1999,0,1771,Blaine McCallister,155,109,46
1999,0,7867,Woody Austin,156,59,97
1999,0,21007,Gabriel Hjertstedt,156,42,114
1999,0,1203,Russ Cochran,157,62,95
1999,0,1577,Lee Janzen,158,145,13
1999,0,20094,Jonathan Kaye,158,27,131
1999,0,2218,Ted Tryba,158,37,121
1999,0,20229,Stewart Cink,159,48,111
1999,0,1569,Peter Jacobsen,159,56,103
1999,0,6044,Scott Gump,162,157,5
1999,0,8537,J.P. Hayes,165,47,118
1999,0,6809,Bob Burns,166,70,96
1999,0,2104,Jeff Sluman,166,128,38
1999,0,19824,Craig Barlow,168,22,146
1999,0,20498,Briny Baird,169,70,99
1999,0,1139,Olin Browne,169,163,6
1999,0,10809,Jim Furyk,169,161,8
1999,0,1926,Steve Pate,169,119,50
1999,0,1927,Dennis Paulson,170,10,160
1999,0,6062,Charles Raulerson,170,39,131
1999,0,23614,Rich Beem,173,87,86
1999,0,11123,Chris Couch,175,2,173
1999,0,10733,Kent Jones,175,112,63
1999,0,19881,Robert Damron,176,56,120
1999,0,2257,Brian Watts,176,145,31
1999,0,10425,Jay Williamson,177,84,93
1999,0,1063,Ben Bates,178,116,62
1999,0,23621,Rory Sabbatini,180,4,176
1999,0,2106,Chris Smith,180,6,174
1999,0,20098,Stuart Appleby,181,25,156
1999,0,1132,Mark Brooks,181,166,15
1999,0,6643,Paul Goydos,181,160,21
1999,0,11032,Frank Lickliter II,181,142,39
1999,0,10649,Tom Scherrer,181,52,129
1999,0,21949,Joe Ogilvie,182,42,140
1999,0,7457,Steve Flesch,183,74,109
1999,0,12652,Cameron Beckman,184,25,159
1999,0,1533,P.H. Horgan III,184,137,47
1999,0,10457,Frank Nobilo,184,163,21
1999,0,6315,Pete Jordan,186,169,17
1999,0,1823,Larry Mize,186,172,14
1999,0,1975,Tom Purtzer,187,45,142
1999,0,1191,Barry Cheesman,188,7,181
1999,0,2133,Craig Stadler,189,46,143
1999,0,6140,Sean Murphy,190,148,42
1999,0,8123,Jeff Brehaut,191,118,73
1999,0,1226,Fred Couples,191,15,176
1999,0,10585,Scott McCarron,191,7,184
1999,0,2023,Clarence Rose,191,107,84
1999,0,23623,Bo Van Pelt,192,21,171
1999,0,1249,John Daly,193,1,192
1999,0,1633,Tom Kite,194,102,92
1999,0,1928,Corey Pavin,195,192,3
1999,0,6617,Brian Henninger,196,95,101
1999,0,2206,David Toms,196,62,134
1999,0,8993,Franklin Langham,199,108,91
1999,0,6599,John Elliott,200,18,182
1999,0,1385,Jim Gallagher Jr.,200,20,180
1999,0,1996,Mike Reid,200,188,12
1999,0,6595,Kevin Sutherland,200,90,110
1999,0,1157,Tom Byrum,201,177,24
1999,0,1042,Paul Azinger,202,86,116
1999,0,20593,Greg Chalmers,202,59,143
1999,0,1941,Tom Pernice Jr.,202,104,98
1999,0,2010,Loren Roberts,202,191,11
1999,0,6655,Geoffrey Sisk,202,145,57
1999,0,1116,Michael Bradley,203,31,172
1999,0,8547,John Maginnes,204,176,28
1999,0,20127,Chris Riley,204,99,105
1999,0,11011,Mike Sposa,205,136,69
1999,0,1098,Jay Don Blake,206,152,54
1999,0,6581,David Sutherland,208,126,82
1999,0,12645,Brent Geiberger,209,82,127
1999,0,8375,Paul Stankowski,209,30,179
1999,0,2279,Mark Wiebe,209,142,67
1999,0,1219,John Cook,210,165,45
1999,0,12823,Carlos Franco,211,41,170
1999,0,1707,Steve Lowery,211,96,115
1999,0,21959,Ted Purdy,211,76,135
1999,0,7749,Brett Quigley,211,50,161
1999,0,20213,Katsumasa Miyamoto,212,34,178
1999,0,1920,Craig Parry,213,114,99
1999,0,10963,Jimmy Green,214,66,148
1999,0,6078,Esteban Toledo,214,181,33
1999,0,1361,Dan Forsman,215,70,145
1999,0,1282,Trevor Dodds,216,64,152
1999,0,7763,Doug Dunakey,219,69,150
1999,0,1527,Scott Hoch,219,144,75
1999,0,8553,Lee Porter,219,183,36
1999,0,8385,Omar Uresti,220,168,52
1999,0,1705,Tim Loustalot,221,180,41
1999,0,1127,Danny Briggs,222,166,56
1999,0,22292,David Seawell,224,36,188
1999,0,2146,Payne Stewart,225,153,72
1999,0,1014,Fulton Allem,230,179,51
1999,0,6251,Chris DiMarco,230,67,163
1999,0,6527,Steve Stricker,230,64,166
1999,0,1599,Steve Jones,231,77,154
1999,0,2267,D.A. Weibring,231,170,61
1999,0,1096,Phil Blackmar,232,49,183
1999,0,10569,Mike Brisky,232,161,71
1999,0,1261,Jay Delsing,232,94,138
1999,0,1266,Clark Dennis,232,174,58
1999,0,2007,Larry Rinker,232,189,43
1999,0,7781,Ty Armstrong,233,131,102
1999,0,2101,Joey Sindelar,233,129,104
1999,0,6012,Greg Kraft,237,149,88
1999,0,19846,Brian Gay,238,130,108
1999,0,1175,Jim Carter,239,156,83
1999,0,1510,Nolan Henke,242,182,60
1999,0,6613,Tommy Tolles,243,56,187
1999,0,8075,Jerry Kelly,244,89,155
1999,0,10213,Dicky Pride,245,158,87
1999,0,1093,Ronnie Black,247,79,168
1999,0,1374,Robin Freeman,248,97,151
1999,0,7101,Dave Stockton Jr.,248,109,139
1999,0,6014,Eric Booker,252,85,167
1999,0,2008,Lee Rinker,252,173,79
1999,0,6332,Neal Lancaster,253,88,165
1999,0,10107,Deane Pappas,253,67,186
1999,0,1376,Bob Friend,256,175,81
1999,0,12663,Phil Tataurangi,257,104,153
1999,0,1185,Brandel Chamblee,259,134,125
1999,0,20099,Doug Barron,260,131,129
1999,0,1457,Jay Haas,260,154,106
1999,0,2321,Fuzzy Zoeller,263,122,141
1999,0,1331,Rick Fehr,264,141,123
1999,0,1323,Brad Fabel,267,139,128
1999,0,2099,Scott Simpson,276,186,90
1999,0,1748,Doug Martin,277,183,94
1999,0,1024,Billy Andrade,280,122,158
1999,0,1887,Mark O'Meara,283,150,133
1999,0,1388,Robert Gamez,290,171,119
1999,0,1604,Steve Jurgensen,297,150,147
1999,0,1378,David Frost,299,137,162
1999,0,2242,Lanny Wadkins,299,186,113
1999,0,6064,Jeff Gallagher,304,140,164
1999,0,1891,David Ogrin,304,178,126
1999,0,20124,Alan Bratton,306,131,175
1999,0,2131,Mike Springer,307,122,185
1999,0,7753,Kevin Wentworth,325,134,191
1999,0,1329,Brad Faxon,327,158,169
1999,0,1549,Mike Hulbert,344,155,189
1999,0,2294,Willie Wood,347,190,157
1999,0,1072,Chip Beck,374,185,189
1998,0,2170,Hal Sutton,62,58,4
1998,0,9011,David Duval,66,6,60
1998,0,2246,Duffy Waldorf,70,29,41
1998,0,10962,Bradley Hughes,71,21,50
1998,0,1968,Nick Price,72,53,19
1998,0,1553,John Huston,77,25,52
1998,0,6575,Dudley Hart,91,55,36
1998,0,1771,Blaine McCallister,96,70,26
1998,0,1361,Dan Forsman,100,49,51
1998,0,1185,Brandel Chamblee,110,51,59
1998,0,1706,Davis Love III,112,15,97
1998,0,21584,Richie Coughlan,114,29,85
1998,0,6621,Joe Durant,114,108,6
1998,0,1599,Steve Jones,116,11,105
1998,0,1063,Ben Bates,117,77,40
1998,0,1408,Kelly Gibson,118,10,108
1998,0,8793,Tiger Woods,118,2,116
1998,0,1161,Mark Calcavecchia,119,28,91
1998,0,12645,Brent Geiberger,120,52,68
1998,0,19881,Robert Damron,121,27,94
1998,0,1766,Billy Mayfair,124,92,32
1998,0,1677,Tom Lehman,126,91,35
1998,0,1035,Tommy Armour III,128,13,115
1998,0,10809,Jim Furyk,130,110,20
1998,0,2245,Grant Waite,132,37,95
1998,0,7569,Mark Carnevale,133,111,22
1998,0,1381,Fred Funk,133,126,7
1998,0,1533,P.H. Horgan III,133,103,30
1998,0,2002,John Riegger,135,90,45
1998,0,1810,Phil Mickelson,136,9,127
1998,0,8931,Glen Day,137,71,66
1998,0,2133,Craig Stadler,137,57,80
1998,0,1945,Kenny Perry,140,18,122
1998,0,21805,Harrison Frazar,142,3,139
1998,0,1527,Scott Hoch,142,117,25
1998,0,1203,Russ Cochran,143,74,69
1998,0,1577,Lee Janzen,144,45,99
1998,0,1414,Bob Gilder,145,97,48
1998,0,1619,Skip Kendall,145,106,39
1998,0,2214,Kirk Triplett,145,131,14
1998,0,1724,Jeff Maggert,146,143,3
1998,0,2239,Scott Verplank,147,66,81
1998,0,6567,Vijay Singh,149,20,129
1998,0,1261,Jay Delsing,153,23,130
1998,0,8375,Paul Stankowski,155,44,111
1998,0,6643,Paul Goydos,156,133,23
1998,0,1823,Larry Mize,156,154,2
1998,0,1266,Clark Dennis,157,146,11
1998,0,10860,Justin Leonard,157,128,29
1998,0,1797,Rocco Mediate,158,88,70
1998,0,6004,Stephen Ames,159,103,56
1998,0,1723,Andrew Magee,159,55,104
1998,0,6044,Scott Gump,160,152,8
1998,0,1320,Bob Estes,161,106,55
1998,0,6522,Ernie Els,162,42,120
1998,0,1042,Paul Azinger,164,36,128
1998,0,1157,Tom Byrum,165,155,10
1998,0,10585,Scott McCarron,165,4,161
1998,0,1941,Tom Pernice Jr.,165,31,134
1998,0,10733,Kent Jones,166,95,71
1998,0,20229,Stewart Cink,168,71,97
1998,0,8993,Franklin Langham,168,82,86
1998,0,1705,Tim Loustalot,168,163,5
1998,0,2223,Bob Tway,168,50,118
1998,0,7457,Steve Flesch,170,12,158
1998,0,12782,Tim Herron,170,17,153
1998,0,7749,Brett Quigley,170,33,137
1998,0,1376,Bob Friend,171,155,16
1998,0,1326,Nick Faldo,172,155,17
1998,0,1388,Robert Gamez,172,108,64
1998,0,20094,Jonathan Kaye,172,84,88
1998,0,20099,Doug Barron,173,97,76
1998,0,8075,Jerry Kelly,173,54,119
1998,0,1707,Steve Lowery,173,33,140
1998,0,1943,Chris Perry,173,89,84
1998,0,1685,J.L. Lewis,174,15,159
1998,0,2135,Mike Standly,174,60,114
1998,0,11032,Frank Lickliter II,176,158,18
1998,0,1334,Keith Fergus,178,40,138
1998,0,1920,Craig Parry,179,100,79
1998,0,20098,Stuart Appleby,180,25,155
1998,0,19883,Joe Daley,180,146,34
1998,0,1191,Barry Cheesman,181,7,174
1998,0,2023,Clarence Rose,181,119,62
1998,0,1226,Fred Couples,182,4,178
1998,0,1353,Bruce Fleisher,182,181,1
1998,0,1457,Jay Haas,182,145,37
1998,0,1014,Fulton Allem,184,163,21
1998,0,1569,Peter Jacobsen,184,39,145
1998,0,6012,Greg Kraft,184,84,100
1998,0,6090,Jim McGovern,184,61,123
1998,0,2241,Bobby Wadkins,184,95,89
1998,0,1306,David Edwards,185,172,13
1998,0,8553,Lee Porter,186,177,9
1998,0,2267,D.A. Weibring,186,174,12
1998,0,1249,John Daly,187,1,186
1998,0,6251,Chris DiMarco,188,76,112
1998,0,6078,Esteban Toledo,188,173,15
1998,0,2279,Mark Wiebe,188,113,75
1998,0,1139,Olin Browne,189,162,27
1998,0,1468,Gary Hallberg,189,19,170
1998,0,2101,Joey Sindelar,189,97,92
1998,0,2106,Chris Smith,189,14,175
1998,0,2218,Ted Tryba,190,37,153
1998,0,10207,Jimmy Johnston,191,149,42
1998,0,1717,Sandy Lyle,191,43,148
1998,0,1510,Nolan Henke,192,146,46
1998,0,12755,Vance Veazey,193,8,185
1998,0,2008,Lee Rinker,194,150,44
1998,0,12660,Jesper Parnevik,197,140,57
1998,0,8385,Omar Uresti,198,133,65
1998,0,2321,Fuzzy Zoeller,198,167,31
1998,0,1385,Jim Gallagher Jr.,201,21,180
1998,0,19824,Craig Barlow,202,33,169
1998,0,2010,Loren Roberts,202,178,24
1998,0,6527,Steve Stricker,202,66,136
1998,0,2206,David Toms,202,77,125
1998,0,10195,Tim Conley,203,100,103
1998,0,1604,Steve Jurgensen,203,93,110
1998,0,1175,Jim Carter,204,151,53
1998,0,21007,Gabriel Hjertstedt,204,83,121
1998,0,1006,John Adams,205,24,181
1998,0,1219,John Cook,206,163,43
1998,0,8545,Glen Hnatiuk,207,135,72
1998,0,6315,Pete Jordan,208,170,38
1998,0,10457,Frank Nobilo,208,121,87
1998,0,6617,Brian Henninger,209,45,164
1998,0,1098,Jay Don Blake,211,135,76
1998,0,2104,Jeff Sluman,211,138,73
1998,0,1282,Trevor Dodds,213,47,166
1998,0,8537,J.P. Hayes,213,64,149
1998,0,1926,Steve Pate,214,81,133
1998,0,6791,Mark Wurtz,214,113,101
1998,0,6214,Guy Boros,215,75,140
1998,0,1302,R.W. Eaks,215,32,183
1998,0,7235,John Morse,215,187,28
1998,0,2146,Payne Stewart,215,84,131
1998,0,1905,Joe Ozaki,216,126,90
1998,0,1891,David Ogrin,217,135,82
1998,0,1996,Mike Reid,217,184,33
1998,0,7101,Dave Stockton Jr.,222,66,156
1998,0,1068,Andy Bean,223,47,176
1998,0,1475,Donnie Hammond,223,121,102
1998,0,1633,Tom Kite,223,140,83
1998,0,8339,Spike McRoy,223,169,54
1998,0,1096,Phil Blackmar,225,41,184
1998,0,6332,Neal Lancaster,226,94,132
1998,0,1748,Doug Martin,226,179,47
1998,0,7707,Mike Small,227,121,106
1998,0,7087,Hugh Royer III,229,62,167
1998,0,1331,Rick Fehr,230,79,151
1998,0,1960,Don Pooley,231,182,49
1998,0,6132,Sonny Skinner,231,158,73
1998,0,2159,Curtis Strange,231,171,60
1998,0,10423,Mike Weir,231,79,152
1998,0,1116,Michael Bradley,233,62,171
1998,0,6270,Bobby Gage,233,166,67
1998,0,10569,Mike Brisky,238,180,58
1998,0,1093,Ronnie Black,241,73,168
1998,0,2131,Mike Springer,242,69,173
1998,0,1887,Mark O'Meara,243,117,126
1998,0,7753,Kevin Wentworth,243,64,179
1998,0,6613,Tommy Tolles,245,58,187
1998,0,1132,Mark Brooks,246,129,117
1998,0,6595,Kevin Sutherland,247,84,163
1998,0,10213,Dicky Pride,248,185,63
1998,0,2294,Willie Wood,251,175,76
1998,0,1060,Dave Barr,252,143,109
1998,0,6581,David Sutherland,252,102,150
1998,0,1323,Brad Fabel,259,113,146
1998,0,12663,Phil Tataurangi,259,124,135
1998,0,1024,Billy Andrade,267,120,147
1998,0,1607,Brian Kamm,269,112,157
1998,0,21593,Keith Nolan,271,129,142
1998,0,6064,Jeff Gallagher,274,131,143
1998,0,1549,Mike Hulbert,275,103,172
1998,0,2007,Larry Rinker,276,183,93
1998,0,1329,Brad Faxon,280,167,113
1998,0,1928,Corey Pavin,284,188,96
1998,0,1761,Len Mattiace,285,161,124
1998,0,1133,Billy Ray Brown,286,124,162
1998,0,1201,Lennie Clements,293,186,107
1998,0,21631,Iain Steel,298,116,182
1998,0,6056,Jim Estes,299,139,160
1998,0,20154,Guy Hill,317,140,177
1998,0,1378,David Frost,318,153,165
1998,0,2099,Scott Simpson,320,176,144
1998,0,1072,Chip Beck,348,160,188
1997,0,6621,Joe Durant,68,43,25
1997,0,2170,Hal Sutton,75,57,18
1997,0,2245,Grant Waite,79,16,63
1997,0,1945,Kenny Perry,80,23,57
1997,0,1157,Tom Byrum,85,73,12
1997,0,1418,Bill Glasson,89,3,86
1997,0,1677,Tom Lehman,95,55,40
1997,0,1797,Rocco Mediate,96,46,50
1997,0,1968,Nick Price,98,94,4
1997,0,8793,Tiger Woods,99,2,97
1997,0,1161,Mark Calcavecchia,101,14,87
1997,0,9011,David Duval,101,12,89
1997,0,10962,Bradley Hughes,105,31,74
1997,0,2246,Duffy Waldorf,106,15,91
1997,0,6643,Paul Goydos,108,77,31
1997,0,12645,Brent Geiberger,109,24,85
1997,0,1876,Greg Norman,110,75,35
1997,0,20098,Stuart Appleby,116,17,99
1997,0,1633,Tom Kite,117,72,45
1997,0,1766,Billy Mayfair,118,86,32
1997,0,1706,Davis Love III,120,4,116
1997,0,1334,Keith Fergus,121,49,72
1997,0,1457,Jay Haas,123,81,42
1997,0,1810,Phil Mickelson,125,5,120
1997,0,11032,Frank Lickliter II,131,94,37
1997,0,10457,Frank Nobilo,132,59,73
1997,0,19881,Robert Damron,133,68,65
1997,0,1619,Skip Kendall,134,100,34
1997,0,1133,Billy Ray Brown,139,83,56
1997,0,1226,Fred Couples,139,8,131
1997,0,1577,Lee Janzen,141,59,82
1997,0,1035,Tommy Armour III,144,46,98
1997,0,2133,Craig Stadler,144,100,44
1997,0,1042,Paul Azinger,145,46,99
1997,0,1724,Jeff Maggert,145,125,20
1997,0,1388,Robert Gamez,146,35,111
1997,0,8375,Paul Stankowski,148,21,127
1997,0,2223,Bob Tway,148,64,84
1997,0,7003,David Berganio Jr.,149,31,118
1997,0,10809,Jim Furyk,149,144,5
1997,0,1723,Andrew Magee,149,41,108
1997,0,2023,Clarence Rose,151,121,30
1997,0,1326,Nick Faldo,156,150,6
1997,0,1175,Jim Carter,157,131,26
1997,0,12782,Tim Herron,157,13,144
1997,0,1599,Steve Jones,157,18,139
1997,0,1139,Olin Browne,158,148,10
1997,0,2256,Tom Watson,159,104,55
1997,0,2321,Fuzzy Zoeller,159,144,15
1997,0,1313,Steve Elkington,160,79,81
1997,0,6617,Brian Henninger,161,26,135
1997,0,1975,Tom Purtzer,161,22,139
1997,0,2214,Kirk Triplett,161,137,24
1997,0,1707,Steve Lowery,162,20,142
1997,0,1475,Donnie Hammond,163,71,92
1997,0,10585,Scott McCarron,163,7,156
1997,0,20229,Stewart Cink,164,68,96
1997,0,1569,Peter Jacobsen,164,88,76
1997,0,6090,Jim McGovern,165,70,95
1997,0,1381,Fred Funk,166,164,2
1997,0,6044,Scott Gump,166,147,19
1997,0,6567,Vijay Singh,167,9,158
1997,0,7363,Craig Bowden,168,140,28
1997,0,1408,Kelly Gibson,168,11,157
1997,0,2101,Joey Sindelar,168,102,66
1997,0,2159,Curtis Strange,170,137,33
1997,0,8931,Glen Day,171,129,42
1997,0,2279,Mark Wiebe,172,92,80
1997,0,2104,Jeff Sluman,173,103,70
1997,0,6124,Patrick Burke,174,123,51
1997,0,2218,Ted Tryba,174,37,137
1997,0,10837,Kevin Burton,176,116,60
1997,0,6315,Pete Jordan,176,123,53
1997,0,8553,Lee Porter,177,125,52
1997,0,6522,Ernie Els,178,52,126
1997,0,1527,Scott Hoch,178,161,17
1997,0,2146,Payne Stewart,178,57,121
1997,0,1361,Dan Forsman,180,56,124
1997,0,6575,Dudley Hart,182,67,115
1997,0,1533,P.H. Horgan III,183,96,87
1997,0,1771,Blaine McCallister,183,142,41
1997,0,1823,Larry Mize,183,180,3
1997,0,1553,John Huston,184,83,101
1997,0,1920,Craig Parry,184,125,59
1997,0,1098,Jay Don Blake,185,81,104
1997,0,1143,Brad Bryant,185,75,110
1997,0,1219,John Cook,186,132,54
1997,0,7465,Hideki Kase,186,19,167
1997,0,7267,Allen Doyle,187,186,1
1997,0,1014,Fulton Allem,189,175,14
1997,0,12387,Michael Christie,189,27,162
1997,0,1006,John Adams,190,9,181
1997,0,1203,Russ Cochran,190,62,128
1997,0,6613,Tommy Tolles,193,33,160
1997,0,10207,Jimmy Johnston,194,92,102
1997,0,1249,John Daly,195,1,194
1997,0,1487,Jeff Hart,195,179,16
1997,0,7101,Dave Stockton Jr.,195,30,165
1997,0,2242,Lanny Wadkins,195,157,38
1997,0,1306,David Edwards,196,189,7
1997,0,1353,Bruce Fleisher,196,183,13
1997,0,20099,Doug Barron,197,119,78
1997,0,8547,John Maginnes,198,177,21
1997,0,1748,Doug Martin,198,187,11
1997,0,2166,Chip Sullivan,198,5,193
1997,0,12826,Paul Claxton,199,163,36
1997,0,1320,Bob Estes,199,116,83
1997,0,1374,Robin Freeman,199,44,155
1997,0,2010,Loren Roberts,199,191,8
1997,0,2135,Mike Standly,199,61,138
1997,0,1331,Rick Fehr,201,139,62
1997,0,2267,D.A. Weibring,201,162,39
1997,0,1323,Brad Fabel,203,154,49
1997,0,7235,John Morse,203,194,9
1997,0,1960,Don Pooley,203,176,27
1997,0,2095,Larry Silveira,203,25,178
1997,0,1261,Jay Delsing,205,37,168
1997,0,1864,Larry Nelson,205,53,152
1997,0,1941,Tom Pernice Jr.,207,35,172
1997,0,1510,Nolan Henke,210,135,75
1997,0,1891,David Ogrin,210,141,69
1997,0,21007,Gabriel Hjertstedt,211,88,123
1997,0,6515,Shaun Micheel,211,29,182
1997,0,12660,Jesper Parnevik,211,108,103
1997,0,2226,Tray Tyner,211,188,23
1997,0,1996,Mike Reid,212,190,22
1997,0,1489,Steve Hart,214,185,29
1997,0,2049,Gene Sauers,214,121,93
1997,0,6034,Marco Dawson,215,27,188
1997,0,1385,Jim Gallagher Jr.,215,45,170
1997,0,1185,Brandel Chamblee,217,83,134
1997,0,7749,Brett Quigley,217,37,180
1997,0,1116,Michael Bradley,219,42,177
1997,0,1682,Wayne Levi,219,173,46
1997,0,10569,Mike Brisky,220,159,61
1997,0,10860,Justin Leonard,220,172,48
1997,0,6595,Kevin Sutherland,220,111,109
1997,0,6036,Scott Dunlap,221,96,125
1997,0,10963,Jimmy Green,222,111,111
1997,0,2206,David Toms,223,50,173
1997,0,6527,Steve Stricker,225,34,191
1997,0,8075,Jerry Kelly,227,108,119
1997,0,1096,Phil Blackmar,232,40,192
1997,0,1761,Len Mattiace,232,86,146
1997,0,10213,Dicky Pride,232,165,67
1997,0,1943,Chris Perry,233,143,90
1997,0,6144,John Dowdall,234,157,77
1997,0,1093,Ronnie Black,235,74,161
1997,0,2008,Lee Rinker,235,156,79
1997,0,6581,David Sutherland,235,96,139
1997,0,1040,Emlyn Aubrey,236,178,58
1997,0,10505,Shane Bertsch,236,115,121
1997,0,1444,Ken Green,236,65,171
1997,0,1288,Ed Dougherty,238,88,150
1997,0,5466,Jack O'Keefe,238,106,132
1997,0,10875,Todd Demsey,240,53,187
1997,0,8265,Eric Johnson,240,51,189
1997,0,1346,Ed Fiori,242,195,47
1997,0,1717,Sandy Lyle,242,79,163
1997,0,7867,Woody Austin,246,99,147
1997,0,1024,Billy Andrade,247,104,143
1997,0,7087,Hugh Royer III,248,63,185
1997,0,1905,Joe Ozaki,250,120,130
1997,0,6214,Guy Boros,251,146,105
1997,0,1196,Brian Claar,254,148,106
1997,0,8339,Spike McRoy,254,160,94
1997,0,6332,Neal Lancaster,255,77,178
1997,0,8385,Omar Uresti,255,184,71
1997,0,1201,Lennie Clements,256,192,64
1997,0,20158,Anthony Rodriguez,256,66,190
1997,0,8537,J.P. Hayes,261,132,129
1997,0,1928,Corey Pavin,261,193,68
1997,0,2115,Taylor Smith,263,88,175
1997,0,6012,Greg Kraft,268,114,154
1997,0,12663,Phil Tataurangi,268,132,136
1997,0,1926,Steve Pate,271,107,164
1997,0,1132,Mark Brooks,277,170,107
1997,0,2292,Bob Wolcott,286,135,151
1997,0,2294,Willie Wood,287,173,114
1997,0,6132,Sonny Skinner,293,182,111
1997,0,2225,Howard Twitty,294,108,186
1997,0,7547,Craig Kanada,296,113,183
1997,0,1378,David Frost,298,150,148
1997,0,2007,Larry Rinker,298,181,117
1997,0,2239,Scott Verplank,299,154,145
1997,0,1307,Joel Edwards,300,167,133
1997,0,2131,Mike Springer,302,118,184
1997,0,1549,Mike Hulbert,303,129,174
1997,0,2099,Scott Simpson,303,150,153
1997,0,6577,John Wilson,304,128,176
1997,0,2100,Tim Simpson,317,168,149
1997,0,1887,Mark O'Meara,322,153,169
1997,0,1011,Rafael Alarcon,329,170,159
1997,0,1329,Brad Faxon,331,165,166
1997,0,1072,Chip Beck,364,169,195
1996,0,9011,David Duval,47,29,18
1996,0,1968,Nick Price,62,54,8
1996,0,1876,Greg Norman,78,52,26
1996,0,1706,Davis Love III,83,4,79
1996,0,1945,Kenny Perry,85,44,41
1996,0,1161,Mark Calcavecchia,88,18,70
1996,0,1975,Tom Purtzer,96,16,80
1996,0,7867,Woody Austin,101,16,85
1996,0,1334,Keith Fergus,104,42,62
1996,0,2023,Clarence Rose,106,83,23
1996,0,1810,Phil Mickelson,107,8,99
1996,0,1920,Craig Parry,107,60,47
1996,0,2256,Tom Watson,112,19,93
1996,0,20259,Hisayuki Sasaki,114,79,35
1996,0,1783,Mark McCumber,115,85,30
1996,0,2321,Fuzzy Zoeller,116,65,51
1996,0,6522,Ernie Els,117,15,102
1996,0,10809,Jim Furyk,117,102,15
1996,0,1766,Billy Mayfair,117,98,19
1996,0,1887,Mark O'Meara,117,86,31
1996,0,1196,Brian Claar,119,90,29
1996,0,1388,Robert Gamez,121,24,97
1996,0,2245,Grant Waite,121,34,87
1996,0,1326,Nick Faldo,122,120,2
1996,0,1724,Jeff Maggert,122,80,42
1996,0,1797,Rocco Mediate,122,62,60
1996,0,1677,Tom Lehman,125,37,88
1996,0,2101,Joey Sindelar,126,69,57
1996,0,2146,Payne Stewart,129,39,90
1996,0,1864,Larry Nelson,131,64,67
1996,0,1226,Fred Couples,133,3,130
1996,0,1958,Dan Pohl,134,24,110
1996,0,1313,Steve Elkington,136,109,27
1996,0,1381,Fred Funk,137,136,1
1996,0,20098,Stuart Appleby,141,22,119
1996,0,1577,Lee Janzen,142,90,52
1996,0,1132,Mark Brooks,146,112,34
1996,0,10860,Justin Leonard,146,133,13
1996,0,12660,Jesper Parnevik,146,23,123
1996,0,2133,Craig Stadler,146,52,94
1996,0,2218,Ted Tryba,146,69,77
1996,0,2170,Hal Sutton,147,74,73
1996,0,1771,Blaine McCallister,148,109,39
1996,0,2214,Kirk Triplett,148,117,31
1996,0,1116,Michael Bradley,151,38,113
1996,0,6567,Vijay Singh,151,12,139
1996,0,10425,Jay Williamson,151,30,121
1996,0,1475,Donnie Hammond,153,78,75
1996,0,6617,Brian Henninger,153,33,120
1996,0,6124,Patrick Burke,154,130,24
1996,0,2159,Curtis Strange,154,138,16
1996,0,1139,Olin Browne,156,145,11
1996,0,19883,Joe Daley,156,106,50
1996,0,1837,Gil Morgan,158,102,56
1996,0,1307,Joel Edwards,159,116,43
1996,0,2223,Bob Tway,161,106,55
1996,0,1014,Fulton Allem,162,157,5
1996,0,1042,Paul Azinger,162,47,115
1996,0,1723,Andrew Magee,164,28,136
1996,0,2135,Mike Standly,164,42,122
1996,0,1553,John Huston,165,40,125
1996,0,1408,Kelly Gibson,166,7,159
1996,0,2246,Duffy Waldorf,166,58,108
1996,0,1157,Tom Byrum,167,163,4
1996,0,1569,Peter Jacobsen,168,69,99
1996,0,6643,Paul Goydos,170,124,46
1996,0,20095,Carl Paulson,170,8,162
1996,0,6527,Steve Stricker,173,6,167
1996,0,1306,David Edwards,175,172,3
1996,0,8375,Paul Stankowski,175,26,149
1996,0,1035,Tommy Armour III,176,100,76
1996,0,8931,Glen Day,176,123,53
1996,0,6090,Jim McGovern,176,95,81
1996,0,8337,Mike Heinen,177,32,145
1996,0,1006,John Adams,178,2,176
1996,0,1385,Jim Gallagher Jr.,178,21,157
1996,0,1905,Joe Ozaki,179,95,84
1996,0,1487,Jeff Hart,181,172,9
1996,0,1823,Larry Mize,181,161,20
1996,0,7267,Allen Doyle,182,170,12
1996,0,1527,Scott Hoch,182,114,68
1996,0,11032,Frank Lickliter II,182,84,98
1996,0,10585,Scott McCarron,182,11,171
1996,0,1201,Lennie Clements,183,176,7
1996,0,7235,John Morse,184,178,6
1996,0,1203,Russ Cochran,185,102,83
1996,0,1219,John Cook,187,139,48
1996,0,12782,Tim Herron,187,5,182
1996,0,1040,Emlyn Aubrey,189,145,44
1996,0,1249,John Daly,189,1,188
1996,0,1331,Rick Fehr,189,125,64
1996,0,1707,Steve Lowery,189,47,142
1996,0,6577,John Wilson,189,62,127
1996,0,6315,Pete Jordan,190,95,95
1996,0,1457,Jay Haas,191,125,66
1996,0,1599,Steve Jones,191,10,181
1996,0,10213,Dicky Pride,191,118,73
1996,0,20051,Joe Acosta Jr.,192,13,179
1996,0,2010,Loren Roberts,192,178,14
1996,0,6613,Tommy Tolles,192,27,165
1996,0,1143,Brad Bryant,193,86,107
1996,0,6044,Scott Gump,194,169,25
1996,0,6034,Marco Dawson,195,40,155
1996,0,2267,D.A. Weibring,195,157,38
1996,0,1261,Jay Delsing,196,50,146
1996,0,2104,Jeff Sluman,196,93,103
1996,0,1093,Ronnie Black,197,65,132
1996,0,1748,Doug Martin,199,182,17
1996,0,10569,Mike Brisky,200,167,33
1996,0,6599,John Elliott,200,46,154
1996,0,1346,Ed Fiori,200,190,10
1996,0,1156,Curt Byrum,201,49,152
1996,0,2226,Tray Tyner,201,180,21
1996,0,1175,Jim Carter,202,165,37
1996,0,1604,Steve Jurgensen,203,90,113
1996,0,20505,Lucas Parsons,203,20,183
1996,0,1971,Dillard Pruitt,203,154,49
1996,0,10649,Tom Scherrer,203,77,126
1996,0,1960,Don Pooley,204,182,22
1996,0,2106,Chris Smith,204,14,190
1996,0,6214,Guy Boros,205,68,137
1996,0,1068,Andy Bean,208,31,177
1996,0,12781,Scott Medlin,208,163,45
1996,0,10215,Charlie Rymer,208,35,173
1996,0,1414,Bob Gilder,210,132,78
1996,0,8075,Jerry Kelly,210,109,101
1996,0,1938,David Peoples,210,82,128
1996,0,2008,Lee Rinker,210,156,54
1996,0,6012,Greg Kraft,211,76,135
1996,0,2241,Bobby Wadkins,211,115,96
1996,0,19913,Ron Whittaker,212,151,61
1996,0,7101,Dave Stockton Jr.,213,45,168
1996,0,1435,Wayne Grady,216,177,39
1996,0,8547,John Maginnes,216,147,69
1996,0,1928,Corey Pavin,217,189,28
1996,0,1633,Tom Kite,218,153,65
1996,0,1725,John Mahaffey,220,185,35
1996,0,7087,Hugh Royer III,221,57,164
1996,0,1361,Dan Forsman,222,118,104
1996,0,1378,David Frost,223,106,117
1996,0,1510,Nolan Henke,224,142,82
1996,0,6332,Neal Lancaster,224,58,166
1996,0,1096,Phil Blackmar,225,36,189
1996,0,1185,Brandel Chamblee,225,167,58
1996,0,2206,David Toms,225,56,169
1996,0,1072,Chip Beck,228,88,140
1996,0,2167,Mike Sullivan,230,75,155
1996,0,10203,Bryan Gorman,232,89,143
1996,0,1761,Len Mattiace,233,61,172
1996,0,1603,Jeff Julian,234,54,180
1996,0,12626,Joey Gullion,236,73,163
1996,0,1060,Dave Barr,237,165,72
1996,0,1323,Brad Fabel,237,148,89
1996,0,2115,Taylor Smith,237,51,186
1996,0,8385,Omar Uresti,237,174,63
1996,0,2186,Brian Tennyson,240,125,115
1996,0,1891,David Ogrin,241,135,106
1996,0,1142,Bart Bryant,244,152,92
1996,0,2171,Mike Swartz,245,67,178
1996,0,1996,Mike Reid,246,175,71
1996,0,2201,Jim Thorpe,246,160,86
1996,0,1557,John Inman,247,188,59
1996,0,6140,Sean Murphy,249,144,105
1996,0,1133,Billy Ray Brown,250,112,138
1996,0,1682,Wayne Levi,250,159,91
1996,0,1374,Robin Freeman,255,81,174
1996,0,2099,Scott Simpson,257,139,118
1996,0,1098,Jay Don Blake,258,134,124
1996,0,1200,Keith Clearwater,259,72,187
1996,0,6036,Scott Dunlap,259,98,161
1996,0,1943,Chris Perry,260,149,111
1996,0,6595,Kevin Sutherland,262,102,160
1996,0,2303,Robert Wrenn,268,120,148
1996,0,1444,Ken Green,271,120,151
1996,0,2279,Mark Wiebe,272,142,130
1996,0,6657,Steve Rintoul,275,100,175
1996,0,1549,Mike Hulbert,276,129,147
1996,0,8993,Franklin Langham,278,128,150
1996,0,2131,Mike Springer,278,93,185
1996,0,6066,Gary Rusnak,280,139,141
1996,0,2049,Gene Sauers,294,161,133
1996,0,1701,Bob Lohr,295,186,109
1996,0,1235,Ben Crenshaw,296,184,112
1996,0,1607,Brian Kamm,300,130,170
1996,0,1024,Billy Andrade,307,154,153
1996,0,1320,Bob Estes,307,149,158
1996,0,2242,Lanny Wadkins,310,181,129
1996,0,1329,Brad Faxon,314,170,144
1996,0,6064,Jeff Gallagher,320,136,184
1996,0,10505,Shane Bertsch,321,187,134
1995,0,1968,Nick Price,40,23,17
1995,0,2170,Hal Sutton,58,44,14
1995,0,1569,Peter Jacobsen,60,24,36
1995,0,1876,Greg Norman,64,21,43
1995,0,2245,Grant Waite,73,50,23
1995,0,1690,Bruce Lietzke,83,78,5
1995,0,1418,Bill Glasson,85,51,34
1995,0,2256,Tom Watson,87,22,65
1995,0,9011,David Duval,102,16,86
1995,0,2133,Craig Stadler,103,72,31
1995,0,1706,Davis Love III,104,2,102
1995,0,1035,Tommy Armour III,109,46,63
1995,0,1810,Phil Mickelson,114,36,78
1995,0,2321,Fuzzy Zoeller,117,61,56
1995,0,1313,Steve Elkington,118,38,80
1995,0,1766,Billy Mayfair,119,85,34
1995,0,2008,Lee Rinker,119,94,25
1995,0,2214,Kirk Triplett,120,93,27
1995,0,6527,Steve Stricker,122,14,108
1995,0,1724,Jeff Maggert,123,65,58
1995,0,1771,Blaine McCallister,125,105,20
1995,0,2246,Duffy Waldorf,125,18,107
1995,0,6522,Ernie Els,127,16,111
1995,0,1388,Robert Gamez,133,11,122
1995,0,20095,Carl Paulson,133,8,125
1995,0,1783,Mark McCumber,135,87,48
1995,0,1677,Tom Lehman,136,82,54
1995,0,12660,Jesper Parnevik,136,70,66
1995,0,1143,Brad Bryant,137,52,85
1995,0,6044,Scott Gump,137,122,15
1995,0,1577,Lee Janzen,138,57,81
1995,0,10860,Justin Leonard,138,125,13
1995,0,1161,Mark Calcavecchia,140,25,115
1995,0,1945,Kenny Perry,140,43,97
1995,0,1633,Tom Kite,141,112,29
1995,0,1326,Nick Faldo,143,133,10
1995,0,1475,Donnie Hammond,145,54,91
1995,0,1725,John Mahaffey,145,119,26
1995,0,1381,Fred Funk,146,145,1
1995,0,6643,Paul Goydos,146,79,67
1995,0,2239,Scott Verplank,146,53,93
1995,0,20094,Jonathan Kaye,147,42,105
1995,0,1837,Gil Morgan,148,86,62
1995,0,1334,Keith Fergus,149,55,94
1995,0,2223,Bob Tway,150,62,88
1995,0,6386,Bill Porter,151,142,9
1995,0,1132,Mark Brooks,153,100,53
1995,0,1823,Larry Mize,153,150,3
1995,0,6567,Vijay Singh,153,4,149
1995,0,1226,Fred Couples,155,10,145
1995,0,1457,Jay Haas,156,95,61
1995,0,1553,John Huston,156,20,136
1995,0,1599,Steve Jones,156,38,118
1995,0,1890,Brett Ogle,157,6,151
1995,0,1040,Emlyn Aubrey,158,113,45
1995,0,2159,Curtis Strange,158,150,8
1995,0,1185,Brandel Chamblee,161,109,52
1995,0,1975,Tom Purtzer,161,13,148
1995,0,7867,Woody Austin,162,9,153
1995,0,6617,Brian Henninger,162,72,90
1995,0,1723,Andrew Magee,162,29,133
1995,0,1920,Craig Parry,165,97,68
1995,0,2267,D.A. Weibring,165,141,24
1995,0,1006,John Adams,166,6,160
1995,0,2099,Scott Simpson,166,122,44
1995,0,1196,Brian Claar,168,138,30
1995,0,1887,Mark O'Meara,168,48,120
1995,0,2148,Ray Stewart,169,128,41
1995,0,1014,Fulton Allem,170,159,11
1995,0,1201,Lennie Clements,170,163,7
1995,0,1385,Jim Gallagher Jr.,170,12,158
1995,0,2104,Jeff Sluman,170,66,104
1995,0,1971,Dillard Pruitt,171,132,39
1995,0,8337,Mike Heinen,172,26,146
1995,0,1306,David Edwards,173,169,4
1995,0,2010,Loren Roberts,173,157,16
1995,0,1175,Jim Carter,174,115,59
1995,0,1098,Jay Don Blake,175,89,86
1995,0,7235,John Morse,175,153,22
1995,0,1361,Dan Forsman,177,71,106
1995,0,1374,Robin Freeman,177,34,143
1995,0,2135,Mike Standly,179,38,141
1995,0,1408,Kelly Gibson,180,5,175
1995,0,1938,David Peoples,180,59,121
1995,0,2190,Doug Tewell,180,178,2
1995,0,2180,Harry Taylor,181,131,50
1995,0,1707,Steve Lowery,182,47,135
1995,0,2101,Joey Sindelar,182,68,114
1995,0,6090,Jim McGovern,183,99,84
1995,0,7101,Dave Stockton Jr.,184,29,155
1995,0,7569,Mark Carnevale,185,157,28
1995,0,1249,John Daly,185,1,184
1995,0,6315,Pete Jordan,185,121,64
1995,0,1864,Larry Nelson,185,130,55
1995,0,1142,Bart Bryant,186,129,57
1995,0,6124,Patrick Burke,187,87,100
1995,0,1331,Rick Fehr,187,92,95
1995,0,1607,Brian Kamm,187,63,124
1995,0,1905,Joe Ozaki,188,34,154
1995,0,1156,Curt Byrum,189,28,161
1995,0,1927,Dennis Paulson,189,3,186
1995,0,10425,Jay Williamson,189,80,109
1995,0,1353,Bruce Fleisher,190,184,6
1995,0,10585,Scott McCarron,191,32,159
1995,0,8931,Glen Day,193,102,91
1995,0,10215,Charlie Rymer,193,15,178
1995,0,6214,Guy Boros,195,33,162
1995,0,2226,Tray Tyner,195,177,18
1995,0,8375,Paul Stankowski,197,63,134
1995,0,2241,Bobby Wadkins,197,98,99
1995,0,2111,Mike Smith,198,125,73
1995,0,1116,Michael Bradley,199,19,180
1995,0,6575,Dudley Hart,199,68,131
1995,0,1527,Scott Hoch,199,72,127
1995,0,1705,Tim Loustalot,199,187,12
1995,0,1928,Corey Pavin,199,159,40
1995,0,20051,Joe Acosta Jr.,201,36,165
1995,0,1203,Russ Cochran,201,91,110
1995,0,6048,Dicky Thompson,203,182,21
1995,0,2218,Ted Tryba,204,122,82
1995,0,10145,Tom Hearn,205,186,19
1995,0,1329,Brad Faxon,209,107,102
1995,0,1925,Jerry Pate,209,72,137
1995,0,1414,Bob Gilder,210,133,77
1995,0,2146,Payne Stewart,210,66,144
1995,0,1550,Ed Humenik,211,59,152
1995,0,1701,Bob Lohr,211,179,32
1995,0,1797,Rocco Mediate,211,115,96
1995,0,8385,Omar Uresti,211,173,38
1995,0,7721,Pat Bates,212,27,185
1995,0,1986,Joey Rassett,212,165,47
1995,0,1266,Clark Dennis,213,163,50
1995,0,1682,Wayne Levi,215,169,46
1995,0,1619,Skip Kendall,216,140,76
1995,0,6613,Tommy Tolles,216,29,187
1995,0,6332,Neal Lancaster,217,38,179
1995,0,1996,Mike Reid,217,184,33
1995,0,1960,Don Pooley,218,182,36
1995,0,2049,Gene Sauers,218,95,123
1995,0,2225,Howard Twitty,218,106,112
1995,0,1261,Jay Delsing,219,82,137
1995,0,1219,John Cook,221,147,74
1995,0,1510,Nolan Henke,221,146,75
1995,0,1891,David Ogrin,221,179,42
1995,0,1060,Dave Barr,225,143,82
1995,0,6088,Steve Gotsche,225,153,72
1995,0,1096,Phil Blackmar,226,49,177
1995,0,1685,J.L. Lewis,226,58,168
1995,0,8563,Bruce Vaughan,226,45,181
1995,0,1042,Paul Azinger,227,80,147
1995,0,6577,John Wilson,227,77,150
1995,0,6034,Marco Dawson,228,56,172
1995,0,1072,Chip Beck,230,117,113
1995,0,1748,Doug Martin,230,181,49
1995,0,2094,Tony Sills,233,173,60
1995,0,1458,Jerry Haas,236,168,68
1995,0,10569,Mike Brisky,237,167,70
1995,0,1320,Bob Estes,237,108,129
1995,0,1378,David Frost,237,166,71
1995,0,1093,Ronnie Black,243,76,167
1995,0,1549,Mike Hulbert,244,125,119
1995,0,6197,Michael Allen,248,84,164
1995,0,10809,Jim Furyk,250,149,101
1995,0,1235,Ben Crenshaw,251,172,79
1995,0,1444,Ken Green,252,136,116
1995,0,1307,Joel Edwards,254,138,116
1995,0,6809,Bob Burns,258,119,139
1995,0,8537,J.P. Hayes,259,89,170
1995,0,10213,Dicky Pride,260,162,98
1995,0,1330,David Feherty,264,175,89
1995,0,6657,Steve Rintoul,265,109,156
1995,0,8717,Kawika Cotner,273,133,140
1995,0,6012,Greg Kraft,277,150,127
1995,0,2279,Mark Wiebe,279,137,142
1995,0,1943,Chris Perry,281,155,126
1995,0,6251,Chris DiMarco,282,100,182
1995,0,1468,Gary Hallberg,285,109,176
1995,0,1926,Steve Pate,285,114,171
1995,0,2167,Mike Sullivan,285,102,183
1995,0,1992,Don Reese,288,156,132
1995,0,2131,Mike Springer,290,102,188
1995,0,1133,Billy Ray Brown,291,118,173
1995,0,6641,Jeff Leonard,300,171,129
1995,0,6791,Mark Wurtz,309,143,166
1995,0,1200,Keith Clearwater,321,147,174
1995,0,1024,Billy Andrade,328,159,169
1995,0,2242,Lanny Wadkins,333,176,157
1995,0,1129,Bill Britton,351,188,163
1994,0,1968,Nick Price,45,6,39
1994,0,1418,Bill Glasson,48,8,40
1994,0,1876,Greg Norman,51,8,43
1994,0,2321,Fuzzy Zoeller,54,29,25
1994,0,2256,Tom Watson,63,37,26
1994,0,1837,Gil Morgan,67,53,14
1994,0,1361,Dan Forsman,76,49,27
1994,0,2170,Hal Sutton,78,65,13
1994,0,8337,Mike Heinen,80,10,70
1994,0,1690,Bruce Lietzke,80,63,17
1994,0,1550,Ed Humenik,84,24,60
1994,0,1388,Robert Gamez,87,5,82
1994,0,1783,Mark McCumber,93,65,28
1994,0,1724,Jeff Maggert,95,52,43
1994,0,1553,John Huston,99,11,88
1994,0,1475,Donnie Hammond,100,53,47
1994,0,6128,Steve Lamontagne,101,22,79
1994,0,2133,Craig Stadler,101,17,84
1994,0,1569,Peter Jacobsen,103,79,24
1994,0,1677,Tom Lehman,103,34,69
1994,0,1266,Clark Dennis,105,89,16
1994,0,1975,Tom Purtzer,113,30,83
1994,0,1320,Bob Estes,120,78,42
1994,0,1633,Tom Kite,120,91,29
1994,0,1457,Jay Haas,122,71,51
1994,0,1723,Andrew Magee,122,30,92
1994,0,1890,Brett Ogle,122,14,108
1994,0,2246,Duffy Waldorf,123,25,98
1994,0,1014,Fulton Allem,124,113,11
1994,0,1771,Blaine McCallister,124,77,47
1994,0,2135,Mike Standly,125,23,102
1994,0,1945,Kenny Perry,128,61,67
1994,0,6527,Steve Stricker,132,39,93
1994,0,1385,Jim Gallagher Jr.,134,12,122
1994,0,1823,Larry Mize,134,129,5
1994,0,1219,John Cook,135,114,21
1994,0,6575,Dudley Hart,137,51,86
1994,0,1725,John Mahaffey,137,133,4
1994,0,1577,Lee Janzen,140,81,59
1994,0,2225,Howard Twitty,141,68,73
1994,0,2099,Scott Simpson,142,105,37
1994,0,2101,Joey Sindelar,142,68,74
1994,0,2214,Kirk Triplett,142,109,33
1994,0,6090,Jim McGovern,143,55,88
1994,0,1920,Craig Parry,143,85,58
1994,0,6214,Guy Boros,145,28,117
1994,0,6016,Brad Lardon,146,71,75
1994,0,2245,Grant Waite,146,114,32
1994,0,7569,Mark Carnevale,149,130,19
1994,0,1766,Billy Mayfair,151,110,41
1994,0,2095,Larry Silveira,153,33,120
1994,0,6567,Vijay Singh,153,12,141
1994,0,6643,Paul Goydos,154,120,34
1994,0,1559,Hale Irwin,154,148,6
1994,0,1072,Chip Beck,155,103,52
1994,0,1306,David Edwards,156,155,1
1994,0,1060,Dave Barr,157,108,49
1994,0,1161,Mark Calcavecchia,159,17,142
1994,0,1313,Steve Elkington,160,26,134
1994,0,2131,Mike Springer,160,16,144
1994,0,2159,Curtis Strange,160,125,35
1994,0,2218,Ted Tryba,160,99,61
1994,0,6617,Brian Henninger,161,37,124
1994,0,1381,Fred Funk,162,160,2
1994,0,6657,Steve Rintoul,162,41,121
1994,0,6809,Bob Burns,165,111,54
1994,0,2267,D.A. Weibring,165,155,10
1994,0,7101,Dave Stockton Jr.,166,34,132
1994,0,8931,Glen Day,169,83,86
1994,0,1378,David Frost,169,131,38
1994,0,1706,Davis Love III,169,1,168
1994,0,1201,Lennie Clements,170,148,22
1994,0,1810,Phil Mickelson,170,15,155
1994,0,1891,David Ogrin,170,163,7
1994,0,1938,David Peoples,170,43,127
1994,0,1971,Dillard Pruitt,170,158,12
1994,0,6609,Rob Boldt,171,45,126
1994,0,1607,Brian Kamm,171,64,107
1994,0,2241,Bobby Wadkins,171,76,95
1994,0,1408,Kelly Gibson,172,6,166
1994,0,6332,Neal Lancaster,173,17,156
1994,0,1928,Corey Pavin,173,158,15
1994,0,2010,Loren Roberts,173,150,23
1994,0,1156,Curt Byrum,174,21,153
1994,0,1527,Scott Hoch,174,106,68
1994,0,1226,Fred Couples,175,3,172
1994,0,1329,Brad Faxon,175,74,101
1994,0,1006,John Adams,177,20,157
1994,0,2190,Doug Tewell,177,174,3
1994,0,1864,Larry Nelson,178,98,80
1994,0,1927,Dennis Paulson,178,2,176
1994,0,6020,Steve Brodie,179,107,72
1994,0,1098,Jay Don Blake,180,102,78
1994,0,1353,Bruce Fleisher,180,171,9
1994,0,12661,Todd Barranger,182,4,178
1994,0,1203,Russ Cochran,182,91,91
1994,0,2033,Dave Rummells,182,88,94
1994,0,1392,Tom Garner,183,175,8
1994,0,1701,Bob Lohr,183,165,18
1994,0,2146,Payne Stewart,183,36,147
1994,0,6140,Sean Murphy,184,139,45
1994,0,1682,Wayne Levi,185,119,66
1994,0,2201,Jim Thorpe,185,80,105
1994,0,1330,David Feherty,187,123,64
1994,0,1510,Nolan Henke,187,111,76
1994,0,12660,Jesper Parnevik,188,55,133
1994,0,1143,Brad Bryant,190,67,123
1994,0,1707,Steve Lowery,190,61,129
1994,0,1926,Steve Pate,190,94,96
1994,0,1374,Robin Freeman,191,60,131
1994,0,7235,John Morse,191,161,30
1994,0,1331,Rick Fehr,192,74,118
1994,0,1414,Bob Gilder,192,137,55
1994,0,1093,Ronnie Black,193,58,135
1994,0,1261,Jay Delsing,193,32,161
1994,0,6062,Charles Raulerson,194,49,145
1994,0,1116,Michael Bradley,196,26,170
1994,0,1139,Olin Browne,196,140,56
1994,0,6315,Pete Jordan,196,150,46
1994,0,10213,Dicky Pride,196,90,106
1994,0,1557,John Inman,197,177,20
1994,0,1468,Gary Hallberg,199,47,152
1994,0,1996,Mike Reid,199,163,36
1994,0,6078,Esteban Toledo,201,170,31
1994,0,8375,Paul Stankowski,203,87,116
1994,0,2167,Mike Sullivan,203,43,160
1994,0,1196,Brian Claar,204,154,50
1994,0,1435,Wayne Grady,204,127,77
1994,0,1288,Ed Dougherty,206,136,70
1994,0,10809,Jim Furyk,207,150,57
1994,0,6251,Chris DiMarco,209,59,150
1994,0,6088,Steve Gotsche,209,100,109
1994,0,6034,Marco Dawson,210,39,171
1994,0,2223,Bob Tway,211,48,163
1994,0,1887,Mark O'Meara,212,82,130
1994,0,1905,Joe Ozaki,216,97,119
1994,0,6577,John Wilson,216,42,174
1994,0,1824,Yoshinori Mizumaki,219,157,62
1994,0,6197,Michael Allen,220,95,125
1994,0,1096,Phil Blackmar,220,45,175
1994,0,1444,Ken Green,220,123,97
1994,0,2206,David Toms,222,73,149
1994,0,2067,Ted Schulz,224,57,167
1994,0,1132,Mark Brooks,226,114,112
1994,0,2100,Tim Simpson,226,146,80
1994,0,1549,Mike Hulbert,229,141,88
1994,0,1629,Eddie Kirby,229,166,63
1994,0,1495,Morris Hatalsky,232,168,64
1994,0,2230,Stan Utley,232,179,53
1994,0,1986,Joey Rassett,233,134,99
1994,0,2090,Tom Sieckmann,233,68,165
1994,0,1185,Brandel Chamblee,235,132,103
1994,0,6791,Mark Wurtz,235,84,151
1994,0,1200,Keith Clearwater,241,127,114
1994,0,2049,Gene Sauers,241,103,138
1994,0,1755,Dick Mast,245,145,100
1994,0,1648,Billy Kratzert,247,85,162
1994,0,6012,Greg Kraft,250,138,112
1994,0,6591,Rocky Walcher,250,91,159
1994,0,2303,Robert Wrenn,250,114,136
1994,0,1748,Doug Martin,252,167,85
1994,0,12663,Phil Tataurangi,254,96,158
1994,0,2322,Richard Zokol,257,147,110
1994,0,1307,Joel Edwards,258,143,115
1994,0,1024,Billy Andrade,261,118,143
1994,0,1235,Ben Crenshaw,266,120,146
1994,0,2239,Scott Verplank,274,126,148
1994,0,2224,Greg Twiggs,277,100,177
1994,0,2242,Lanny Wadkins,277,173,104
1994,0,2104,Jeff Sluman,278,141,137
1994,0,6589,Jeff Woodland,287,176,111
1994,0,7781,Ty Armstrong,292,153,139
1994,0,1282,Trevor Dodds,293,120,173
1994,0,2007,Larry Rinker,297,169,128
1994,0,6058,John Flannery,298,144,154
1994,0,6350,Bob May,298,134,164
1994,0,2294,Willie Wood,301,161,140
1994,0,1129,Bill Britton,341,172,169
1994,0,1133,Billy Ray Brown,357,178,179
1993,0,1876,Greg Norman,42,9,33
1993,0,1968,Nick Price,46,11,35
1993,0,1837,Gil Morgan,62,46,16
1993,0,2321,Fuzzy Zoeller,68,12,56
1993,0,1771,Blaine McCallister,70,51,19
1993,0,1724,Jeff Maggert,71,57,14
1993,0,1418,Bill Glasson,74,35,39
1993,0,2256,Tom Watson,76,27,49
1993,0,1042,Paul Azinger,78,12,66
1993,0,6090,Jim McGovern,80,38,42
1993,0,1690,Bruce Lietzke,101,89,12
1993,0,1569,Peter Jacobsen,103,71,32
1993,0,2146,Payne Stewart,106,23,83
1993,0,1783,Mark McCumber,109,55,54
1993,0,1945,Kenny Perry,109,27,82
1993,0,1797,Rocco Mediate,110,73,37
1993,0,1958,Dan Pohl,116,20,96
1993,0,1475,Donnie Hammond,117,92,25
1993,0,1633,Tom Kite,121,62,59
1993,0,1682,Wayne Levi,121,77,44
1993,0,1823,Larry Mize,122,95,27
1993,0,1014,Fulton Allem,124,117,7
1993,0,1320,Bob Estes,127,67,60
1993,0,2133,Craig Stadler,127,33,94
1993,0,1938,David Peoples,128,50,78
1993,0,1313,Steve Elkington,129,37,92
1993,0,6044,Scott Gump,129,72,57
1993,0,1331,Rick Fehr,135,86,49
1993,0,1677,Tom Lehman,135,24,111
1993,0,1723,Andrew Magee,135,65,70
1993,0,1408,Kelly Gibson,137,17,120
1993,0,2225,Howard Twitty,139,30,109
1993,0,1388,Robert Gamez,141,93,48
1993,0,1550,Ed Humenik,141,15,126
1993,0,7569,Mark Carnevale,143,115,28
1993,0,1971,Dillard Pruitt,143,141,2
1993,0,6617,Brian Henninger,149,59,90
1993,0,1846,Jodie Mudd,150,12,138
1993,0,1510,Nolan Henke,152,45,107
1993,0,1619,Skip Kendall,152,100,52
1993,0,2101,Joey Sindelar,152,38,114
1993,0,2190,Doug Tewell,152,151,1
1993,0,1559,Hale Irwin,153,149,4
1993,0,1203,Russ Cochran,154,80,74
1993,0,6643,Paul Goydos,156,126,30
1993,0,2245,Grant Waite,156,59,97
1993,0,6124,Patrick Burke,157,106,51
1993,0,1887,Mark O'Meara,157,68,89
1993,0,2246,Duffy Waldorf,157,25,132
1993,0,2033,Dave Rummells,158,41,117
1993,0,1975,Tom Purtzer,159,32,127
1993,0,2279,Mark Wiebe,159,74,85
1993,0,1132,Mark Brooks,161,115,46
1993,0,1706,Davis Love III,161,2,159
1993,0,1219,John Cook,162,124,38
1993,0,2159,Curtis Strange,162,142,20
1993,0,6086,Russell Beiersdorf,163,51,112
1993,0,1527,Scott Hoch,164,106,58
1993,0,2267,D.A. Weibring,164,158,6
1993,0,1060,Dave Barr,165,98,67
1993,0,1810,Phil Mickelson,165,26,139
1993,0,6136,Mike Schuchart,165,84,81
1993,0,2218,Ted Tryba,166,68,98
1993,0,1890,Brett Ogle,167,6,161
1993,0,1306,David Edwards,168,163,5
1993,0,1707,Steve Lowery,169,40,129
1993,0,1361,Dan Forsman,170,84,86
1993,0,1766,Billy Mayfair,170,155,15
1993,0,2100,Tim Simpson,171,140,31
1993,0,1381,Fred Funk,173,170,3
1993,0,1457,Jay Haas,174,86,88
1993,0,1920,Craig Parry,175,88,87
1993,0,1414,Bob Gilder,176,112,64
1993,0,2049,Gene Sauers,177,75,102
1993,0,1196,Brian Claar,178,138,40
1993,0,1928,Corey Pavin,178,165,13
1993,0,1006,John Adams,179,5,174
1993,0,2135,Mike Standly,179,22,157
1993,0,1191,Barry Cheesman,180,4,176
1993,0,1201,Lennie Clements,180,146,34
1993,0,1378,David Frost,180,77,103
1993,0,1553,John Huston,180,18,162
1993,0,1577,Lee Janzen,180,117,63
1993,0,1261,Jay Delsing,181,8,173
1993,0,1143,Brad Bryant,182,34,148
1993,0,1249,John Daly,183,1,182
1993,0,2010,Loren Roberts,183,174,9
1993,0,6006,JC Anderson,184,18,166
1993,0,1200,Keith Clearwater,184,109,75
1993,0,1385,Jim Gallagher Jr.,184,30,154
1993,0,1607,Brian Kamm,184,56,128
1993,0,2131,Mike Springer,184,43,141
1993,0,6575,Dudley Hart,185,48,137
1993,0,1226,Fred Couples,186,7,179
1993,0,1564,David Jackson,186,3,183
1993,0,1701,Bob Lohr,187,176,11
1993,0,2214,Kirk Triplett,187,132,55
1993,0,1157,Tom Byrum,188,178,10
1993,0,1353,Bruce Fleisher,191,173,18
1993,0,1129,Bill Britton,192,123,69
1993,0,1725,John Mahaffey,192,166,26
1993,0,1648,Billy Kratzert,193,75,118
1993,0,6128,Steve Lamontagne,193,21,172
1993,0,1096,Phil Blackmar,194,16,178
1993,0,1035,Tommy Armour III,195,64,131
1993,0,6599,John Elliott,195,10,185
1993,0,1346,Ed Fiori,195,187,8
1993,0,1024,Billy Andrade,196,97,99
1993,0,2224,Greg Twiggs,197,51,146
1993,0,1185,Brandel Chamblee,198,122,76
1993,0,6197,Michael Allen,199,57,142
1993,0,1288,Ed Dougherty,199,120,79
1993,0,1891,David Ogrin,200,177,23
1993,0,10795,Neale Smith,200,44,156
1993,0,6401,Marty Schiene,201,136,65
1993,0,2104,Jeff Sluman,201,80,121
1993,0,1072,Chip Beck,202,102,100
1993,0,6144,John Dowdall,202,181,21
1993,0,6566,Jaime Gomez,202,159,43
1993,0,2099,Scott Simpson,202,134,68
1993,0,1049,Ian Baker-Finch,204,159,45
1993,0,1864,Larry Nelson,204,124,80
1993,0,2180,Harry Taylor,204,168,36
1993,0,1495,Morris Hatalsky,205,188,17
1993,0,2111,Mike Smith,205,132,73
1993,0,2090,Tom Sieckmann,206,66,140
1993,0,2217,Dennis Trixler,206,144,62
1993,0,2241,Bobby Wadkins,206,91,115
1993,0,1934,Dave Peege,207,183,24
1993,0,1557,John Inman,208,186,22
1993,0,2303,Robert Wrenn,208,102,106
1993,0,6332,Neal Lancaster,209,42,167
1993,0,2067,Ted Schulz,210,77,133
1993,0,1093,Ronnie Black,213,61,152
1993,0,1307,Joel Edwards,214,153,61
1993,0,1443,Hubert Green,214,185,29
1993,0,1161,Mark Calcavecchia,215,46,169
1993,0,10195,Tim Conley,215,174,41
1993,0,1116,Michael Bradley,217,29,188
1993,0,6034,Marco Dawson,217,36,181
1993,0,1468,Gary Hallberg,222,51,171
1993,0,2242,Lanny Wadkins,223,170,53
1993,0,1469,Dan Halldorson,224,80,144
1993,0,8045,Perry Moss,224,109,115
1993,0,2322,Richard Zokol,224,153,71
1993,0,1098,Jay Don Blake,226,104,122
1993,0,1533,P.H. Horgan III,226,113,113
1993,0,5319,Gene Jones,226,142,84
1993,0,1946,Peter Persons,226,179,47
1993,0,8553,Lee Porter,227,136,91
1993,0,2206,David Toms,228,93,135
1993,0,1374,Robin Freeman,230,70,160
1993,0,1926,Steve Pate,230,100,130
1993,0,1736,Roger Maltbie,231,138,93
1993,0,1068,Andy Bean,232,48,184
1993,0,1715,Mark Lye,232,62,170
1993,0,1444,Ken Green,238,113,125
1993,0,2201,Jim Thorpe,243,134,109
1993,0,1197,Bobby Clampett,244,80,164
1993,0,2007,Larry Rinker,245,168,77
1993,0,2185,Lance Ten Broeck,245,98,147
1993,0,1218,Jeff Cook,249,130,119
1993,0,10207,Jimmy Johnston,252,148,104
1993,0,8759,Tad Rhyan,256,184,72
1993,0,1284,Mike Donald,257,149,108
1993,0,1235,Ben Crenshaw,258,95,163
1993,0,1930,Eddie Pearce,258,104,154
1993,0,2298,Jim Woodward,258,90,168
1993,0,1761,Len Mattiace,260,126,134
1993,0,6012,Greg Kraft,262,119,143
1993,0,2294,Willie Wood,266,130,136
1993,0,1435,Wayne Grady,273,172,101
1993,0,1282,Trevor Dodds,274,109,165
1993,0,6589,Jeff Woodland,276,182,94
1993,0,2170,Hal Sutton,278,128,150
1993,0,1549,Mike Hulbert,279,155,124
1993,0,1755,Dick Mast,285,162,123
1993,0,6058,John Flannery,286,128,158
1993,0,6247,David Delong,294,189,105
1993,0,1329,Brad Faxon,294,145,149
1993,0,1390,Buddy Gardner,295,106,189
1993,0,2255,Denis Watson,295,120,175
1993,0,1323,Brad Fabel,308,157,151
1993,0,1849,Bill Murchison,316,163,153
1993,0,6284,Jim Hallet,324,179,145
1993,0,1659,Massy Kuramoto,324,147,177
1993,0,2223,Bob Tway,338,152,186
1993,0,6691,Greg Cesario,347,167,180
1993,0,1248,Rick Dalpos,348,161,187
